"AverageShortestPathLength","BetweennessCentrality","ClosenessCentrality","ClusteringCoefficient","Eccentricity","EdgeCount","Indegree","IsSingleNode","name","NeighborhoodConnectivity","Outdegree","PartnerOfMultiEdgedNodePairs","selected","SelfLoops","shared name","Stress"
"5.201106567235987","6.307891802509999","0.192266777669858","0.21428571428571427","11","16","8","false","3466","7.375","8","8","false","0","3466","445053725"
"5.363002165022853","1.1344762420096304","0.1864627253969678","0.3","11","10","5","false","937","8.8","5","5","false","0","937","99796589"
"5.5181621361558815","0.0","0.18121975674615284","1.0","12","4","2","false","5233","10.5","2","2","false","0","5233","0"
"5.576377195092615","1.4558040859890293","0.17932789784737502","0.3","10","10","5","false","8579","7.0","5","5","false","0","8579","107288380"
"4.641327880683185","28.831155101968722","0.215455582046232","0.05128205128205128","11","26","13","false","10310","11.23076923076923","13","13","false","0","10310","2525035866"
"5.020928554245851","9.99530733084876","0.19916634725948637","0.2","11","20","10","false","15931","9.7","10","10","false","0","15931","745503291"
"5.016357950445032","33.38361854559292","0.19934781566201507","0.1323529411764706","10","34","17","false","17038","9.235294117647058","17","17","false","0","17038","4228587415"
"5.784219388982439","0.0","0.17288417550426283","1.0","12","6","3","false","18720","7.333333333333333","3","3","false","0","18720","0"
"5.715179215780611","0.13151103174294793","0.1749726407946797","0.6666666666666666","11","8","4","false","19607","6.5","4","4","false","0","19607","12216053"
"5.388741881164301","2.0710671352204817","0.185572072675327","0.25","11","16","8","false","1854","6.125","8","8","false","0","1854","172894400"
"5.36853500120279","1.1262880049928765","0.18627055607832593","0.3333333333333333","12","6","3","false","4583","11.333333333333334","3","3","false","0","4583","75268615"
"4.19581428915083","88.51460201331916","0.23833276000458664","0.0659536541889483","10","68","34","false","9572","12.058823529411764","34","34","false","0","9572","8918983611"
"5.174885734904979","9.458933718641372","0.1932409817776125","0.09523809523809523","11","14","7","false","10841","10.142857142857142","7","7","false","0","10841","721565030"
"4.78253548231898","11.767688564596577","0.20909410995422767","0.17777777777777778","11","20","10","false","13056","10.2","10","10","false","0","13056","1037624331"
"5.3678133269184505","0.0","0.18629559917540559","1.0","12","4","2","false","14982","11.5","2","2","false","0","14982","0"
"4.496271349530912","36.342300950503414","0.22240650580493285","0.08823529411764706","10","34","17","false","16310","12.235294117647058","17","17","false","0","16310","3110157367"
"4.549194130382487","26.114066521146857","0.2198191528739887","0.24333333333333335","10","50","25","false","19640","20.12","25","25","false","0","19640","3563268199"
"5.289872504209766","9.220633985702953","0.1890404729422465","0.14285714285714285","11","16","8","false","23855","7.875","8","8","false","0","23855","919522856"
"5.6410873225884055","0.0","0.17727078891257994","0.0","12","2","1","false","24372","13.0","1","1","false","0","24372","0"
"5.077700264613904","12.761305187390537","0.1969395489861664","0.26666666666666666","11","42","21","false","24814","8.285714285714286","21","21","false","0","24814","954932987"
"4.334616309838826","82.41577567074276","0.23070092679948942","0.06157635467980296","9","58","29","false","5052","10.827586206896552","29","29","false","0","5052","7292012744"
"5.037527062785663","0.2218293986258288","0.19851009980421183","0.6666666666666666","10","6","3","false","899","19.666666666666668","3","3","false","0","899","27370593"
"5.237430839547751","0.0","0.19093330883703838","1.0","10","4","2","false","1796","20.0","2","2","false","0","1796","0"
"4.816935289872505","12.044642696105932","0.20760087894526566","0.17582417582417584","10","28","14","false","2287","9.714285714285714","14","14","false","0","2287","1011225404"
"4.755833533798413","6.689602814113754","0.21026808295397065","0.2727272727272727","10","24","12","false","3096","11.583333333333334","12","12","false","0","3096","686345928"
"4.921337503006976","10.984085680675495","0.20319679343044286","0.41818181818181815","10","22","11","false","3386","10.636363636363637","11","11","false","0","3386","847751304"
"4.993264373346163","3.769433519308581","0.20026978850508265","0.16666666666666666","10","8","4","false","4472","14.75","4","4","false","0","4472","298553552"
"4.683184989174886","39.39103394682837","0.21352989521265667","0.07894736842105263","10","40","20","false","5346","7.7","20","20","false","0","5346","3024885526"
"5.334375751744046","0.0","0.18746335963923336","0.0","10","2","1","false","5740","29.0","1","1","false","0","5740","0"
"4.980514794322829","1.8874562479437125","0.200782457496136","0.5","10","8","4","false","6094","16.5","4","4","false","0","6094","154293191"
"5.257156603319702","0.0","0.19021689393246086","1.0","10","4","2","false","6376","16.5","2","2","false","0","6376","0"
"4.84700505171999","24.896276283628026","0.20631296838552782","0.09057971014492754","9","48","24","false","9124","6.666666666666667","24","24","false","0","9124","2143173835"
"4.681982198700986","6.942443739412883","0.2135847505523301","0.1794871794871795","10","26","13","false","10235","13.307692307692308","13","13","false","0","10235","845453457"
"4.980033678133269","7.160261899640432","0.20080185489324703","0.2857142857142857","10","16","8","false","10427","14.375","8","8","false","0","10427","650191342"
"5.233100793841713","3.5082159664443955","0.19109129355520824","0.2","10","12","6","false","10597","11.166666666666666","6","6","false","0","10597","282406415"
"5.1106567235987495","0.65877543585115","0.19566956931042598","0.5","10","8","4","false","15159","14.25","4","4","false","0","15159","84315402"
"4.377676208804426","50.70387180095023","0.22843169579074624","0.11764705882352941","10","36","18","false","16148","14.833333333333334","18","18","false","0","16148","4528905515"
"5.221072889102718","7.494501550471184","0.19153151492812387","0.23809523809523808","10","14","7","false","16741","10.857142857142858","7","7","false","0","16741","601879464"
"5.334375751744046","0.0","0.18746335963923336","0.0","10","2","1","false","18235","29.0","1","1","false","0","18235","0"
"5.334375751744046","0.0","0.18746335963923336","0.0","10","2","1","false","18549","29.0","1","1","false","0","18549","0"
"4.7481356747654555","21.598792520217064","0.2106089776066471","0.075","10","32","16","false","19297","9.5","16","16","false","0","19297","1798023448"
"4.47871060861198","33.793938911388786","0.2232785476420668","0.3165322580645161","10","64","32","false","20511","16.125","32","32","false","0","20511","3824325982"
"4.908828482078422","18.145053447227873","0.20371459374693715","0.19444444444444445","10","18","9","false","20595","13.444444444444445","9","9","false","0","20595","1925242837"
"4.842193889824393","7.546632178352176","0.20651795916339608","0.2","10","20","10","false","20613","11.7","10","10","false","0","20613","770934933"
"4.464036564830407","37.323522911670636","0.22401250202080078","0.14285714285714285","10","44","22","false","24371","12.818181818181818","22","22","false","0","24371","3807944273"
"4.5528025018041856","28.67458391948855","0.21964493289654444","0.05928853754940711","10","46","23","false","24559","8.478260869565217","23","23","false","0","24559","2482696537"
"5.334375751744046","0.0","0.18746335963923336","0.0","10","2","1","false","24731","29.0","1","1","false","0","24731","0"
"4.882848207842194","4.8343179482543635","0.20479850231549906","0.47619047619047616","9","14","7","false","25102","17.428571428571427","7","7","false","0","25102","487487885"
"4.550878037045947","15.765318092765211","0.2197378158367692","0.175","10","32","16","false","25271","19.1875","16","16","false","0","25271","2114016306"
"4.518643252345441","11.976840798980904","0.22130536626916525","0.5731225296442688","10","46","23","false","25396","22.08695652173913","23","23","false","0","25396","1539445159"
"5.3764734183305265","2.920492548586212","0.18599552572706937","0.4","10","12","6","false","1658","11.333333333333334","6","6","false","0","1658","205071019"
"5.671397642530671","0.0","0.1763233797081778","1.0","11","4","2","false","4822","12.0","2","2","false","0","4822","0"
"5.647101274957902","0.0","0.17708200212992548","1.0","11","4","2","false","6864","13.0","2","2","false","0","6864","0"
"4.3228289631946115","84.56254017176391","0.23132999443516972","0.05040322580645161","10","64","32","false","7689","10.8125","32","32","false","0","7689","7385025957"
"4.772191484243445","14.543266034724034","0.2095473334005444","0.25","10","18","9","false","7926","14.333333333333334","9","9","false","0","7926","1536640770"
"5.423141688717825","5.755700962487116","0.18439496096522356","0.14285714285714285","11","14","7","false","10268","7.0","7","7","false","0","10268","415076178"
"5.682944431080106","0.0","0.17596512021672875","0.0","11","2","1","false","12971","20.0","1","1","false","0","12971","0"
"5.6148664902573975","3.206481336748598","0.17809862473758623","0.3333333333333333","11","8","4","false","18600","9.0","4","4","false","0","18600","205109753"
"5.550878037045947","2.4735937280098623","0.1801516793066089","0.3333333333333333","11","6","3","false","20421","11.333333333333334","3","3","false","0","20421","179016370"
"5.576858311282175","0.0","0.17931242720959323","1.0","10","4","2","false","20886","22.0","2","2","false","0","20886","0"
"5.52225162376714","5.557615308913645","0.18108555497473428","0.2","11","12","6","false","21048","8.166666666666666","6","6","false","0","21048","401350527"
"5.0223719028145295","1.7860854262692947","0.19910911006801418","0.3","11","10","5","false","22393","15.6","5","5","false","0","22393","163923929"
"5.244166466201587","2.24199555448862","0.19068807339449542","0.4666666666666667","10","12","6","false","23186","13.333333333333334","6","6","false","0","23186","243039901"
"5.681501082511427","2.799815205540569","0.17600982301634346","0.16666666666666666","11","8","4","false","23214","6.25","4","4","false","0","23214","189514328"
"5.576858311282175","0.0","0.17931242720959323","1.0","10","4","2","false","23298","22.0","2","2","false","0","23298","0"
"5.530190040894876","0.0","0.18082561224933663","1.0","10","6","3","false","23945","16.666666666666668","3","3","false","0","23945","0"
"5.381525138320905","4.03654645501872","0.18582092888114074","0.3333333333333333","11","6","3","false","24939","15.666666666666666","3","3","false","0","24939","247860336"
"4.504209766658648","16.4279295408898","0.22201452681051057","0.35172413793103446","10","60","30","false","339","16.733333333333334","30","30","false","0","339","2150133751"
"4.523454414241039","15.936564679351118","0.22106998510955117","0.3382352941176471","10","34","17","false","624","16.294117647058822","17","17","false","0","624","1832813651"
"5.142410392109695","0.0","0.19446133695092854","1.0","11","18","9","false","3731","13.777777777777779","9","9","false","0","3731","0"
"4.562905941784941","19.074829712149313","0.21915858287642342","0.5","10","50","25","false","4743","21.48","25","25","false","0","4743","1971764854"
"5.142410392109695","0.0","0.19446133695092854","1.0","11","18","9","false","5407","13.777777777777779","9","9","false","0","5407","0"
"4.356266538369016","46.738185933725894","0.2295543652327572","0.47058823529411764","10","136","68","false","6610","40.720588235294116","68","68","false","0","6610","7829811054"
"4.371421698340149","25.163787393975944","0.22875852960598725","0.2021505376344086","9","62","31","false","6700","18.161290322580644","31","31","false","0","6700","3058181867"
"4.8097185470291075","15.57488114374508","0.20791237371211363","0.3238095238095238","11","30","15","false","8045","20.733333333333334","15","15","false","0","8045","1675999742"
"5.142410392109695","0.0","0.19446133695092854","1.0","11","18","9","false","9099","13.777777777777779","9","9","false","0","9099","0"
"5.071686312244407","9.058562029985772","0.1971730778352227","0.36989247311827955","11","62","31","false","9639","18.483870967741936","31","31","false","0","9639","2602768862"
"4.450805869617513","25.75004592323452","0.22467841314452489","0.4868305531167691","10","136","68","false","9785","40.5735294117647","68","68","false","0","9785","5504992797"
"5.116189559778687","2.4791719929215335","0.19545796501786722","0.1","10","10","5","false","12141","11.8","5","5","false","0","12141","244567058"
"5.133750300697619","4.660710400794861","0.19478937256923293","0.5384615384615384","11","26","13","false","15184","11.923076923076923","13","13","false","0","15184","746950695"
"5.074332451286986","3.5612031487222646","0.19707025694510288","0.5272727272727272","11","22","11","false","15784","25.636363636363637","11","11","false","0","15784","469992024"
"4.67356266538369","4.670155724596485","0.2139695285155446","0.2987012987012987","10","44","22","false","18719","29.318181818181817","22","22","false","0","18719","900609794"
"5.074091893192206","3.054971908811373","0.19707959986725454","0.5571428571428572","11","42","21","false","19870","21.333333333333332","21","21","false","0","19870","1039244199"
"5.059658407505412","3.164202619599362","0.1976418009794133","0.5157894736842106","11","40","20","false","20532","21.35","20","20","false","0","20532","924735245"
"5.072889102718307","13.22414622972965","0.1971263277693475","0.4066666666666667","11","50","25","false","22527","18.88","25","25","false","0","22527","2689562244"
"5.440702429636757","1.9855992755936795","0.1837997966131671","0.3333333333333333","11","8","4","false","23576","8.75","4","4","false","0","23576","198741940"
"5.142410392109695","0.0","0.19446133695092854","1.0","11","18","9","false","23577","13.777777777777779","9","9","false","0","23577","0"
"5.142410392109695","0.0","0.19446133695092854","1.0","11","18","9","false","23649","13.777777777777779","9","9","false","0","23649","0"
"5.018522973298052","2.7886509732181293","0.19926181574153962","0.2","10","12","6","false","24199","14.0","6","6","false","0","24199","380149762"
"4.63194611498677","15.669533739483244","0.21589197611010125","0.25263157894736843","10","40","20","false","24293","12.85","20","20","false","0","24293","1632122379"
"4.876112581188357","1.7619373539078744","0.2050814010853478","0.5256410256410257","11","26","13","false","25201","16.076923076923077","13","13","false","0","25201","311926243"
"4.8272792879480395","5.385920733715203","0.20715602730851645","0.38461538461538464","10","28","14","false","10243","26.5","14","14","false","0","10243","802273242"
"4.687033918691364","6.582674450459878","0.21335454732087866","0.28205128205128205","11","54","27","false","6774","25.074074074074073","27","27","false","0","6774","1434756987"
"4.986047630502767","0.0","0.20055965648670815","1.0","11","16","8","false","8049","41.0","8","8","false","0","8049","0"
"5.458503728650469","0.0","0.18320038781895906","1.0","11","6","3","false","8053","11.333333333333334","3","3","false","0","8053","0"
"5.218186191965359","0.6709128205200318","0.19163747003503598","0.42857142857142855","11","14","7","false","8517","13.571428571428571","7","7","false","0","8517","114519575"
"5.156122203512148","7.341788296564538","0.19394420080246336","0.1794871794871795","11","26","13","false","11964","8.692307692307692","13","13","false","0","11964","792650292"
"4.793360596584075","8.060778396776822","0.20862190103382514","0.42857142857142855","10","28","14","false","15538","27.928571428571427","14","14","false","0","15538","954332786"
"5.241760885253789","1.8788848908160998","0.19077558513079396","0.3055555555555556","11","18","9","false","16694","9.88888888888889","9","9","false","0","16694","223007666"
"5.621602116911234","0.3733878548019877","0.1778852325730669","0.3333333333333333","11","8","4","false","18648","9.0","4","4","false","0","18648","65144030"
"4.4558575896078905","25.133198687349424","0.22442368946714894","0.5335381464413722","10","126","63","false","19423","41.904761904761905","63","63","false","0","19423","4732868054"
"4.2518643252345445","41.69929070386236","0.23519094766619517","0.3638888888888889","10","162","81","false","21012","35.81481481481482","81","81","false","0","21012","7883167279"
"4.5710849170074574","42.86474495587821","0.21876644563730133","0.1839080459770115","10","60","30","false","22457","20.333333333333332","30","30","false","0","22457","5403091912"
"4.292999759441905","37.57928151098818","0.23293735290821474","0.35816814764183186","10","154","77","false","22691","35.18181818181818","77","77","false","0","22691","5684555866"
"4.6680298292037525","4.2864877930327525","0.21422313836640042","0.3852813852813853","11","44","22","false","23452","28.318181818181817","22","22","false","0","23452","801735251"
"5.930719268703392","0.6999345017603148","0.16861361239555447","0.3333333333333333","12","8","4","false","16174","6.5","4","4","false","0","16174","104672004"
"1.0","0.0","1.0","0.0","1","2","1","false","16470","1.0","1","1","false","0","16470","0"
"1.0","0.0","1.0","0.0","1","2","1","false","17822","1.0","1","1","false","0","17822","0"
"4.646139042578783","72.95351403748943","0.2152324738531635","0.021021021021021023","10","74","37","false","14265","5.891891891891892","37","37","false","0","14265","5679859817"
"5.645898484484003","0.0","0.17711972731146144","0.0","11","2","1","false","392","37.0","1","1","false","0","392","0"
"5.300216502285302","0.0","0.18867153814732446","1.0","11","4","2","false","2485","31.0","2","2","false","0","2485","0"
"4.668992061582872","14.395952498854752","0.2141789891287547","0.1388888888888889","10","18","9","false","2949","19.22222222222222","9","9","false","0","2949","1415652166"
"5.645898484484003","0.0","0.17711972731146144","0.0","11","2","1","false","3173","37.0","1","1","false","0","3173","0"
"5.481597305749339","5.19004878802545","0.18242857769781015","0.2","11","12","6","false","3441","9.5","6","6","false","0","3441","347060948"
"5.461630983882608","2.69082584884149","0.18309548978153628","0.06666666666666667","10","12","6","false","3593","10.0","6","6","false","0","3593","209907049"
"5.645898484484003","0.0","0.17711972731146144","0.0","11","2","1","false","3853","37.0","1","1","false","0","3853","0"
"5.645657926389223","0.0","0.17712727427670544","1.0","11","4","2","false","3927","20.5","2","2","false","0","3927","0"
"5.224200144334857","0.4142137077050267","0.19141686236588848","0.5","11","8","4","false","3937","17.25","4","4","false","0","3937","50980048"
"5.505893673322107","4.413628935711024","0.18162355819643483","0.8888888888888888","11","36","18","false","3939","19.22222222222222","18","18","false","0","3939","318128949"
"4.5792638922299735","35.43666893917939","0.21837570918260138","0.09803921568627451","10","36","18","false","5107","11.222222222222221","18","18","false","0","5107","2924513130"
"5.645657926389223","0.0","0.17712727427670544","1.0","11","4","2","false","5218","19.5","2","2","false","0","5218","0"
"5.602116911234063","1.1721508394064324","0.17850395053246307","0.0","11","4","2","false","5230","23.5","2","2","false","0","5230","87813769"
"5.506134231416887","3.2220699353848032","0.18161562322512997","0.16666666666666666","11","8","4","false","6030","15.0","4","4","false","0","6030","227600159"
"4.744767861438538","26.061883556414628","0.21075846684242547","0.08771929824561403","10","38","19","false","7350","9.105263157894736","19","19","false","0","7350","2630285984"
"5.1987009862881886","7.716145063818571","0.19235574475961317","0.14545454545454545","11","22","11","false","7504","9.727272727272727","11","11","false","0","7504","684553616"
"5.645657926389223","0.0","0.17712727427670544","1.0","11","4","2","false","7601","19.5","2","2","false","0","7601","0"
"5.644936252104883","0.0","0.17714991903179067","1.0","11","4","2","false","8718","21.0","2","2","false","0","8718","0"
"5.018282415203272","6.523810951822099","0.19927136762379558","0.2","11","10","5","false","9522","17.0","5","5","false","0","9522","541908777"
"5.493144094298773","3.7853492910287043","0.18204510619662798","0.7142857142857143","11","14","7","false","11621","12.428571428571429","7","7","false","0","11621","239845461"
"5.47774837623286","2.183327075098297","0.18255676079223573","0.0","11","4","2","false","12498","24.5","2","2","false","0","12498","123137550"
"5.599951888381044","0.0","0.17857296275613213","1.0","11","4","2","false","12691","21.5","2","2","false","0","12691","0"
"5.645898484484003","0.0","0.17711972731146144","0.0","11","2","1","false","15251","37.0","1","1","false","0","15251","0"
"4.970411354342073","6.659621034868914","0.2011905914238699","0.47619047619047616","10","14","7","false","16020","13.0","7","7","false","0","16020","463923830"
"5.645898484484003","0.0","0.17711972731146144","0.0","11","2","1","false","16261","37.0","1","1","false","0","16261","0"
"5.645417368294443","0.0","0.17713482188512017","1.0","11","6","3","false","17156","14.333333333333334","3","3","false","0","17156","0"
"5.044743805629059","14.916403714402993","0.19822612178723","0.13333333333333333","11","32","16","false","17626","8.375","16","16","false","0","17626","1406073581"
"5.6155881645417365","0.0","0.17807573680603153","1.0","11","4","2","false","18622","21.5","2","2","false","0","18622","0"
"5.527784459947077","4.987290924847512","0.1809043039296749","0.3333333333333333","11","12","6","false","19059","10.666666666666666","6","6","false","0","19059","482016035"
"5.645417368294443","0.0","0.17713482188512017","1.0","11","6","3","false","19525","14.333333333333334","3","3","false","0","19525","0"
"4.668751503488092","7.0019012243059775","0.21419002473206925","0.3","10","10","5","false","19738","24.6","5","5","false","0","19738","752199027"
"5.228049073851335","11.009474768272213","0.19127593981502783","0.3333333333333333","11","8","4","false","20122","15.75","4","4","false","0","20122","913520274"
"5.644214577820543","2.3694120600408923","0.1771725695776329","0.3","11","10","5","false","20432","9.2","5","5","false","0","20432","158123480"
"5.645898484484003","0.0","0.17711972731146144","0.0","11","2","1","false","21866","37.0","1","1","false","0","21866","0"
"4.946114986769305","16.07045140473749","0.20217888235008025","0.08888888888888889","10","20","10","false","22074","11.3","10","10","false","0","22074","1194372039"
"5.645417368294443","0.0","0.17713482188512017","1.0","11","6","3","false","23721","14.333333333333334","3","3","false","0","23721","0"
"4.766177531873947","8.884389562872476","0.20981173976681977","0.09090909090909091","11","22","11","false","8916","8.181818181818182","11","11","false","0","8916","906428459"
"4.469328842915564","36.82808132215558","0.22374724150923087","0.07368421052631578","9","40","20","false","13556","9.55","20","20","false","0","13556","3012901341"
"4.184748616790955","79.59404332122212","0.23896297999540123","0.1","9","42","21","false","14485","16.666666666666668","21","21","false","0","14485","8778864946"
"4.810680779408227","19.37700776465113","0.20787078707870785","0.1830065359477124","10","36","18","false","8612","11.722222222222221","18","18","false","0","8612","1996636533"
"4.992783257156604","12.954068670087054","0.20028908696699588","0.16339869281045752","11","36","18","false","615","7.444444444444445","18","18","false","0","615","1044895037"
"5.320182824152033","4.646457491209571","0.18796346536444203","0.25","11","18","9","false","743","9.666666666666666","9","9","false","0","743","436181207"
"5.767139764253067","0.0","0.17339617919412698","1.0","11","4","2","false","2076","14.0","2","2","false","0","2076","0"
"5.496030791436132","2.6387912617510216","0.18194949008622577","0.4642857142857143","11","16","8","false","4515","11.125","8","8","false","0","4515","465999923"
"5.394515275439018","0.0","0.18537346711259756","1.0","11","8","4","false","5773","14.5","4","4","false","0","5773","0"
"4.653836901611739","14.114869491325804","0.21487646025018092","0.22857142857142856","10","42","21","false","9482","27.095238095238095","21","21","false","0","9482","2217936669"
"5.810199663218667","0.0","0.17211112491201921","1.0","11","4","2","false","10822","10.0","2","2","false","0","10822","0"
"5.061101756074092","1.8691947362033858","0.19758543657017918","0.6388888888888888","10","18","9","false","11175","31.555555555555557","9","9","false","0","11175","637392425"
"5.511667067596824","0.0","0.18143331005586594","1.0","11","10","5","false","11604","13.0","5","5","false","0","11604","0"
"5.810199663218667","0.0","0.17211112491201921","1.0","11","4","2","false","14004","10.0","2","2","false","0","14004","0"
"4.4467163820062545","13.381204651296272","0.22488504192588585","0.5753569539925966","10","124","62","false","15003","42.74193548387097","62","62","false","0","15003","2532128151"
"4.8633630021650225","18.41819416021386","0.20561903348666966","0.24183006535947713","10","36","18","false","15552","19.555555555555557","18","18","false","0","15552","2884128492"
"4.876834255472697","12.097013873266864","0.20505105312484584","0.18181818181818182","11","24","12","false","15814","10.916666666666666","12","12","false","0","15814","1172828527"
"5.254991580466683","6.560098622104803","0.19029526207370107","0.37777777777777777","11","20","10","false","16083","9.0","10","10","false","0","16083","554853204"
"5.1190762569160455","7.966742626569027","0.19534774436090224","0.3090909090909091","11","22","11","false","17932","11.454545454545455","11","11","false","0","17932","795437196"
"5.810440221313447","0.0","0.17210399933758383","0.0","11","2","1","false","20001","18.0","1","1","false","0","20001","0"
"4.571566033197017","15.014815794046243","0.2187434224373816","0.13636363636363635","10","24","12","false","20100","12.25","12","12","false","0","20100","1440558019"
"5.166706759682463","0.0","0.1935468851848403","1.0","10","10","5","false","23481","25.6","5","5","false","0","23481","0"
"5.398123646860717","8.804375473268355","0.18524955436720142","0.10256410256410256","11","26","13","false","16258","5.538461538461538","13","13","false","0","16258","823837560"
"5.854462352658167","1.1058173017659085","0.1708098779635945","0.3333333333333333","11","8","4","false","1356","5.25","4","4","false","0","1356","77697691"
"5.329564589848449","7.771818454804932","0.18763258858045587","0.0","11","14","7","false","1727","10.285714285714286","7","7","false","0","1727","784028490"
"5.528265576136637","0.7722928671247221","0.1808885601148775","0.3333333333333333","11","8","4","false","2752","13.25","4","4","false","0","2752","75619898"
"5.403897041135434","2.2673512137334884","0.18505163817663817","0.3","11","10","5","false","4125","17.2","5","5","false","0","4125","291838116"
"6.139283136877556","0.0","0.16288546687042044","1.0","11","6","3","false","6667","9.666666666666666","3","3","false","0","6667","0"
"6.263411113783979","0.0","0.15965741060798094","1.0","12","4","2","false","6825","8.5","2","2","false","0","6825","0"
"5.667308154919413","4.024616620479356","0.17645061335370774","0.12727272727272726","11","22","11","false","10039","6.454545454545454","11","11","false","0","10039","370208290"
"6.139283136877556","0.0","0.16288546687042044","1.0","11","6","3","false","10351","9.666666666666666","3","3","false","0","10351","0"
"4.859273514553765","4.97210373388435","0.20579207920792078","0.8333333333333334","10","24","12","false","11082","22.416666666666668","12","12","false","0","11082","540636721"
"5.403415924945874","10.546521257429752","0.18506811503873208","0.10256410256410256","10","26","13","false","14123","5.6923076923076925","13","13","false","0","14123","866677373"
"6.263411113783979","0.0","0.15965741060798094","1.0","12","4","2","false","16676","8.5","2","2","false","0","16676","0"
"6.397883088765937","0.0","0.15630169950368478","0.0","12","2","1","false","21194","13.0","1","1","false","0","21194","0"
"6.402453692566755","0.28620668478299877","0.15619011835431149","0.6666666666666666","11","6","3","false","10912","6.0","3","3","false","0","10912","41202929"
"5.737551118595141","5.9468572952301475","0.17429038614733136","0.13636363636363635","11","24","12","false","14534","5.25","12","12","false","0","14534","559525166"
"5.300697618474862","2.2461305591637455","0.1886544134331745","0.5","11","8","4","false","17268","15.75","4","4","false","0","17268","184445447"
"6.4031753668510945","0.0","0.15617251483958225","0.0","11","2","1","false","19783","13.0","1","1","false","0","19783","0"
"5.806110175607409","1.610829926432909","0.17223235001657275","0.3333333333333333","11","6","3","false","21705","14.333333333333334","3","3","false","0","21705","100029586"
"6.402453692566755","0.28620668478299877","0.15619011835431149","0.6666666666666666","11","6","3","false","22836","6.0","3","3","false","0","22836","41202929"
"4.484484002886697","76.23787714811576","0.22299109537603262","0.04734848484848485","11","66","33","false","2710","7.333333333333333","33","33","false","0","2710","6169411554"
"5.094058215058936","5.473727610096575","0.1963071401586702","0.19047619047619047","11","14","7","false","62","12.285714285714286","7","7","false","0","62","596883672"
"5.431801780129901","5.6046663332714415","0.18410097431355182","0.5","12","8","4","false","106","11.75","4","4","false","0","106","481280381"
"5.167668992061583","4.257932265243251","0.19351084628991713","0.4","12","10","5","false","260","12.0","5","5","false","0","260","346320969"
"5.192687033918691","3.269040374672928","0.192578523116835","0.2222222222222222","12","20","10","false","2959","9.7","10","10","false","0","2959","372762182"
"4.7832571566033195","9.481424356458579","0.20906256286461478","0.18181818181818182","11","24","12","false","3677","10.833333333333334","12","12","false","0","3677","968480798"
"5.406062063988453","0.0","0.18497752858986338","1.0","11","6","3","false","4708","15.666666666666666","3","3","false","0","4708","0"
"5.275920134712533","13.632379741820333","0.18954039759255883","0.2222222222222222","12","20","10","false","5172","8.3","10","10","false","0","5172","1297800405"
"5.206158287226365","4.447384518792298","0.19208021439792997","0.4","12","12","6","false","5541","12.833333333333334","6","6","false","0","5541","316679241"
"5.421938898243926","0.01592701308549522","0.1844358667199077","0.6666666666666666","12","6","3","false","5794","13.333333333333334","3","3","false","0","5794","1872284"
"4.726004330045706","11.218790571554187","0.2115952356713835","0.16666666666666666","12","18","9","false","5807","16.11111111111111","9","9","false","0","5807","1015271949"
"5.32451286985807","5.932199496795231","0.18781060811421343","0.2545454545454545","12","22","11","false","6575","8.363636363636363","11","11","false","0","6575","479667453"
"5.458744286745249","0.0","0.18319231447206064","1.0","12","4","2","false","8458","21.5","2","2","false","0","8458","0"
"5.484002886697137","0.0","0.1823485546343817","1.0","12","4","2","false","10601","17.5","2","2","false","0","10601","0"
"5.484002886697137","0.0","0.1823485546343817","1.0","12","4","2","false","11401","18.0","2","2","false","0","11401","0"
"5.431801780129901","1.1060112618318991","0.18410097431355182","0.5","12","8","4","false","13026","11.25","4","4","false","0","13026","83734612"
"5.3492903536203995","2.183795043244872","0.18694068444484419","0.4","12","10","5","false","13205","10.6","5","5","false","0","13205","170364663"
"5.415203271590089","13.318006552032395","0.18466527475456443","0.21428571428571427","12","16","8","false","13659","8.25","8","8","false","0","13659","1000289603"
"4.863844118354582","10.548326035857226","0.205598694297443","0.13333333333333333","11","20","10","false","13989","10.5","10","10","false","0","13989","838403275"
"5.375270627856628","0.6739239333124775","0.18603714477511746","0.5","11","8","4","false","14007","14.25","4","4","false","0","14007","81687645"
"5.237430839547751","1.4973652953930832","0.19093330883703838","0.3333333333333333","11","6","3","false","14009","17.666666666666668","3","3","false","0","14009","148426054"
"4.45657926389223","80.03828789371792","0.2243873475116053","0.07816091954022988","10","60","30","false","14599","10.533333333333333","30","30","false","0","14599","7639437048"
"5.484002886697137","0.0","0.1823485546343817","1.0","12","4","2","false","15301","17.5","2","2","false","0","15301","0"
"5.054366129420255","6.954021580282147","0.1978487458950074","0.2857142857142857","11","16","8","false","18757","16.25","8","8","false","0","18757","640443047"
"5.416406062063989","0.8724965709758685","0.18462426718777755","0.4","12","10","5","false","20934","9.6","5","5","false","0","20934","53606655"
"4.953091171517921","3.1499114620928723","0.2018941233608548","0.09523809523809523","11","14","7","false","21543","8.857142857142858","7","7","false","0","21543","247382973"
"4.8710608611979795","5.794067633831167","0.20529408859696774","0.19047619047619047","11","14","7","false","22184","13.428571428571429","7","7","false","0","22184","492289116"
"4.540774597065191","17.375140290272853","0.2202267429540157","0.22727272727272727","10","24","12","false","23647","13.416666666666666","12","12","false","0","23647","1746204259"
"4.442145778205437","41.68063201504536","0.22511643019603594","0.1","10","32","16","false","23708","11.75","16","16","false","0","23708","3728111515"
"5.136155881645418","8.004074481785226","0.1946981406023137","0.2","10","20","10","false","25916","9.3","10","10","false","0","25916","604660222"
"5.457060380081789","0.0","0.18324884284769674","1.0","12","6","3","false","26023","14.0","3","3","false","0","26023","0"
"5.483762328602357","1.4935299943993259","0.18235655378136514","0.0","12","4","2","false","26051","17.0","2","2","false","0","26051","102529895"
"5.4820784219388985","0.0","0.18241256746676027","1.0","12","4","2","false","26100","19.0","2","2","false","0","26100","0"
"5.356988212653356","4.780600333300614","0.18667205532354395","0.2857142857142857","12","14","7","false","214","14.0","7","7","false","0","214","328822222"
"5.977146980995911","0.0","0.1673038998671872","1.0","12","6","3","false","5435","7.0","3","3","false","0","5435","0"
"5.295645898484484","6.003082525174178","0.18883437812301265","0.6564625850340136","11","98","49","false","6512","33.69387755102041","49","49","false","0","6512","633516867"
"5.429877315371662","3.4885709935169054","0.18416622363990784","0.42857142857142855","12","14","7","false","10590","13.571428571428571","7","7","false","0","10590","268183249"
"5.977146980995911","0.0","0.1673038998671872","1.0","12","6","3","false","23559","7.0","3","3","false","0","23559","0"
"5.3415924945874425","4.952801470346743","0.187210087818059","0.07142857142857142","11","16","8","false","1765","4.375","8","8","false","0","1765","375625302"
"4.78277604041376","8.645153044030462","0.2090835931998793","0.16666666666666666","11","24","12","false","3032","11.166666666666666","12","12","false","0","3032","1002637320"
"4.60861197979312","18.643725069526226","0.2169850715105961","0.2","10","22","11","false","5302","11.727272727272727","11","11","false","0","5302","1679836775"
"4.6237671397642535","11.037140377420494","0.21627386712449923","0.1282051282051282","11","26","13","false","7383","12.307692307692308","13","13","false","0","7383","1349549723"
"4.621361558816454","20.708440922952462","0.2163864452657332","0.1568627450980392","11","36","18","false","7442","11.666666666666666","18","18","false","0","7442","2177594665"
"5.0","17.542702028097256","0.2","0.2","11","20","10","false","7768","10.3","10","10","false","0","7768","1584478232"
"4.32523454414241","43.289071131229406","0.23120133481646274","0.12","10","52","26","false","13276","13.115384615384615","26","26","false","0","13276","4791087121"
"4.886456579263892","5.178291606453355","0.20464727022104073","0.3055555555555556","10","18","9","false","17266","12.555555555555555","9","9","false","0","17266","443079726"
"4.78277604041376","8.927843587928152","0.2090835931998793","0.09090909090909091","11","24","12","false","22415","9.666666666666666","12","12","false","0","22415","1075207478"
"7.023334135193649","0.0","0.14238251815317166","1.0","14","4","2","false","10794","4.0","2","2","false","0","10794","0"
"6.023815251383209","3.243263452891545","0.16600774729443712","0.26666666666666666","13","12","6","false","7050","6.166666666666667","6","6","false","0","7050","322559240"
"7.023334135193649","0.0","0.14238251815317166","1.0","14","4","2","false","25850","4.0","2","2","false","0","25850","0"
"5.329324031753669","3.9899485703081408","0.187641058048208","0.19696969696969696","12","24","12","false","10113","9.416666666666666","12","12","false","0","10113","457246183"
"6.634351695934568","0.0","0.1507306283766634","1.0","13","4","2","false","10657","7.0","2","2","false","0","10657","0"
"5.254510464277123","12.441313540399655","0.19031268598635717","0.21818181818181817","12","22","11","false","12130","11.090909090909092","11","11","false","0","12130","1256942006"
"5.751022371902814","1.6888843138695662","0.17388212657380683","0.2857142857142857","12","16","8","false","17172","5.75","8","8","false","0","17172","181147544"
"4.551599711330287","8.502906723395087","0.21970297552983456","0.3463203463203463","10","44","22","false","4846","19.727272727272727","22","22","false","0","4846","1146421747"
"4.3767139764253065","33.828648629965116","0.22848191711553262","0.13846153846153847","10","52","26","false","676","17.923076923076923","26","26","false","0","676","4190835838"
"4.731296608130863","1.4986815011146604","0.21135855196257883","0.7307692307692307","10","26","13","false","824","23.23076923076923","13","13","false","0","824","246042813"
"4.873947558335338","0.21810097267366804","0.20517249888949213","0.8484848484848485","10","24","12","false","2133","21.75","12","12","false","0","2133","41270344"
"4.23863363002165","60.236129163559475","0.2359250851305335","0.2503556187766714","10","76","38","false","2654","19.263157894736842","38","38","false","0","2654","6642266895"
"4.791195573731056","0.37989102696811045","0.20871617211427426","0.8245614035087719","10","38","19","false","4748","22.36842105263158","19","19","false","0","4748","83483026"
"5.329083473658889","0.0","0.18764952828059406","1.0","10","4","2","false","5672","20.5","2","2","false","0","5672","0"
"4.9954293961991825","0.14789752907988868","0.20018299142829624","0.6666666666666666","11","8","4","false","10549","24.75","4","4","false","0","10549","26903628"
"4.874188116430118","0.0","0.2051623729148159","1.0","10","22","11","false","12928","23.363636363636363","11","11","false","0","12928","0"
"4.954053403897041","2.991548108587277","0.20185490919685345","0.2909090909090909","11","22","11","false","13220","13.363636363636363","11","11","false","0","13220","351518444"
"4.821505893673322","0.8761599197420249","0.20740408122536547","0.6593406593406593","10","28","14","false","14419","28.5","14","14","false","0","14419","150692026"
"4.682703872985326","3.8134635481999077","0.21355183396691668","0.47794117647058826","10","34","17","false","17330","17.647058823529413","17","17","false","0","17330","578097879"
"4.611739235025259","9.24663128043573","0.2168379322935684","0.39901477832512317","10","58","29","false","17439","18.620689655172413","29","29","false","0","17439","1230749563"
"4.444310801058456","20.850371029427198","0.22500676589986468","0.21367521367521367","10","54","27","false","18487","15.814814814814815","27","27","false","0","18487","2391253709"
"4.675968246331489","8.45150838358132","0.2138594505607573","0.21904761904761905","10","30","15","false","20850","17.466666666666665","15","15","false","0","20850","1201048799"
"4.874188116430118","0.0","0.2051623729148159","1.0","10","22","11","false","22779","23.363636363636363","11","11","false","0","22779","0"
"4.432764012509021","31.41954451577437","0.22559288001302436","0.2045977011494253","10","60","30","false","23382","16.666666666666668","30","30","false","0","23382","3879852166"
"5.421938898243926","0.09973052181522471","0.1844358667199077","0.4","11","10","5","false","24029","16.4","5","5","false","0","24029","15555944"
"4.484724560981477","29.296485931231008","0.22297913425950758","0.13333333333333333","10","42","21","false","11785","20.0","21","21","false","0","11785","3553991092"
"4.496271349530912","3.6567983731827143","0.22240650580493285","0.8256802721088435","10","98","49","false","45","50.46938775510204","49","49","false","0","45","1128780165"
"4.589607890305508","0.0","0.21788353687300174","1.0","10","84","42","false","46","53.857142857142854","42","42","false","0","46","0"
"4.536925667548713","11.32433222689903","0.22041357370095438","0.875886524822695","10","96","48","false","570","50.895833333333336","48","48","false","0","570","1584126380"
"4.487611258118836","3.6869728587003836","0.22283570088448137","0.7003367003367004","10","110","55","false","773","46.58181818181818","55","55","false","0","773","865886613"
"4.464998797209526","9.451460036176634","0.22396422606540595","0.6532467532467533","10","112","56","false","1653","44.875","56","56","false","0","1653","2294710908"
"4.576858311282175","0.17611548784680914","0.21849048670240723","0.9185938945420906","10","94","47","false","2212","51.851063829787236","47","47","false","0","2212","62934629"
"4.318498917488573","20.662780415976307","0.23156194295900182","0.5413461538461538","10","130","65","false","2741","42.90769230769231","65","65","false","0","2741","4861676861"
"4.577339427471735","6.756144477517961E-4","0.2184675215471936","0.9949494949494949","10","90","45","false","2952","53.955555555555556","45","45","false","0","2952","597329"
"4.575655520808275","0.30578210535383654","0.2185479207192051","0.8554421768707483","10","98","49","false","3372","50.48979591836735","49","49","false","0","3372","99806105"
"5.356025980274236","0.0","0.1867055917359084","0.0","11","2","1","false","4046","68.0","1","1","false","0","4046","0"
"4.536444551359153","15.559038457948187","0.22043694983561352","0.6988120195667366","10","108","54","false","4164","45.7962962962963","54","54","false","0","4164","1997900435"
"4.588886216021169","0.3598842418103717","0.21791780247431325","0.9171717171717172","10","90","45","false","4511","51.46666666666667","45","45","false","0","4511","144770853"
"4.577820543661294","0.0","0.21844456121912773","1.0","10","86","43","false","4513","54.48837209302326","43","43","false","0","4513","0"
"5.356025980274236","0.0","0.1867055917359084","0.0","11","2","1","false","5262","68.0","1","1","false","0","5262","0"
"4.577098869376955","0.5293248332822198","0.2184790035213118","0.9516908212560387","10","92","46","false","6179","52.78260869565217","46","46","false","0","6179","58553871"
"4.577339427471735","6.756144477517961E-4","0.2184675215471936","0.9949494949494949","10","90","45","false","6830","53.955555555555556","45","45","false","0","6830","597329"
"4.505171999037768","3.9286056316817626","0.22196710807347286","0.6844155844155844","10","112","56","false","7956","45.94642857142857","56","56","false","0","7956","1011919924"
"4.577339427471735","6.756144477517961E-4","0.2184675215471936","0.9949494949494949","10","90","45","false","8879","53.955555555555556","45","45","false","0","8879","597329"
"4.501563627616069","5.114250319207247","0.22214503286485332","0.8443877551020408","10","98","49","false","11241","50.42857142857143","49","49","false","0","11241","1102546543"
"4.577339427471735","6.756144477517961E-4","0.2184675215471936","0.9949494949494949","10","90","45","false","11472","53.955555555555556","45","45","false","0","11472","597329"
"4.280250180418571","39.77069072635445","0.23363120328218961","0.38721804511278196","10","154","77","false","12365","36.76623376623377","77","77","false","0","12365","6765930833"
"4.529708924705316","2.6691068897182135","0.22076473712161446","0.8812056737588653","10","96","48","false","12496","51.458333333333336","48","48","false","0","12496","447362296"
"5.222997353860958","2.71492154277121","0.19146094325718496","0.5","11","8","4","false","12678","22.0","4","4","false","0","12678","258521072"
"4.426028385855184","19.27769341266986","0.22593619218435784","0.6585213032581454","10","114","57","false","12781","45.333333333333336","57","57","false","0","12781","2479877278"
"4.577339427471735","6.756144477517961E-4","0.2184675215471936","0.9949494949494949","10","90","45","false","12851","53.955555555555556","45","45","false","0","12851","597329"
"4.559057012268463","1.3339260512906579","0.21934360489658083","0.9526570048309179","10","92","46","false","14540","52.91304347826087","46","46","false","0","14540","224695867"
"4.4654799133990855","9.16727581708149","0.22394009588967304","0.5966101694915255","10","120","60","false","14807","43.63333333333333","60","60","false","0","14807","2201630939"
"4.577339427471735","6.756144477517961E-4","0.2184675215471936","0.9949494949494949","10","90","45","false","15659","53.955555555555556","45","45","false","0","15659","597329"
"4.866730815491941","2.7281001070853113","0.20547674361128962","0.16666666666666666","10","8","4","false","16159","30.0","4","4","false","0","16159","365188074"
"4.197498195814289","61.46310253439773","0.23823714826064532","0.48951048951048953","10","132","66","false","17655","41.43939393939394","66","66","false","0","17655","8598458180"
"4.577339427471735","6.756144477517961E-4","0.2184675215471936","0.9949494949494949","10","90","45","false","17692","53.955555555555556","45","45","false","0","17692","597329"
"4.531633389463556","4.437366387260287","0.2206709841809109","0.9111933395004626","10","94","47","false","18894","51.808510638297875","47","47","false","0","18894","591490020"
"4.577339427471735","6.756144477517961E-4","0.2184675215471936","0.9949494949494949","10","90","45","false","19961","53.955555555555556","45","45","false","0","19961","597329"
"4.577339427471735","6.756144477517961E-4","0.2184675215471936","0.9949494949494949","10","90","45","false","20108","53.955555555555556","45","45","false","0","20108","597329"
"4.577339427471735","6.756144477517961E-4","0.2184675215471936","0.9949494949494949","10","90","45","false","20562","53.955555555555556","45","45","false","0","20562","597329"
"4.576858311282175","0.38269438881579604","0.21849048670240723","0.9167437557816837","10","94","47","false","20635","51.787234042553195","47","47","false","0","20635","154756687"
"4.436612942025499","36.690225872237505","0.2253971696578648","0.3466407010710808","10","158","79","false","21281","33.89873417721519","79","79","false","0","21281","6057939596"
"4.470772191484244","13.12019216095782","0.22367500672585416","0.49886928991406604","10","134","67","false","21508","39.83582089552239","67","67","false","0","21508","2702095482"
"4.576617753187395","0.2996455139083974","0.21850197109067016","0.8882978723404256","10","96","48","false","21847","50.958333333333336","48","48","false","0","21847","97258105"
"4.900649506855905","14.726622455213978","0.20405458472413118","0.26666666666666666","11","12","6","false","22798","20.333333333333332","6","6","false","0","22798","1467459892"
"4.517440461871542","3.422952229790265","0.22136428989829066","0.9158186864014801","10","94","47","false","22887","52.340425531914896","47","47","false","0","22887","594753829"
"4.355544864084677","26.00517665111236","0.2295924003092897","0.7285921625544267","10","106","53","false","23293","47.84905660377358","53","53","false","0","23293","3543729371"
"4.528025018041857","1.7444255096817944","0.22084683631727142","0.7976470588235294","10","102","51","false","24955","49.31372549019608","51","51","false","0","24955","563438399"
"4.459947077219148","6.580396034992156","0.22421790722761598","0.6844155844155844","10","112","56","false","25346","46.232142857142854","56","56","false","0","25346","1392707346"
"4.446475823911475","31.389458866048237","0.224897208396451","0.7764705882352941","10","102","51","false","25758","48.470588235294116","51","51","false","0","25758","4152181291"
"4.921818619196536","2.1529491593148333","0.20317693059628544","0.5238095238095238","10","14","7","false","934","18.571428571428573","7","7","false","0","934","199293120"
"5.371181140245369","0.0","0.18617878896452886","0.0","10","2","1","false","5579","31.0","1","1","false","0","5579","0"
"4.523454414241039","16.49532390848915","0.22106998510955117","0.3311827956989247","10","62","31","false","9755","23.06451612903226","31","31","false","0","9755","2412217720"
"5.32427231176329","0.0","0.18781909366104912","1.0","10","8","4","false","10550","13.5","4","4","false","0","10550","0"
"4.60740918931922","18.54138180635506","0.2170417167023443","0.2","10","32","16","false","16032","19.375","16","16","false","0","16032","1868122369"
"5.371181140245369","0.0","0.18617878896452886","0.0","10","2","1","false","17331","31.0","1","1","false","0","17331","0"
"5.062304546547991","0.30882668124712764","0.19753849078122032","0.3333333333333333","10","8","4","false","17603","21.0","4","4","false","0","17603","41530682"
"4.970170796247293","0.11040130532862968","0.20120032912250135","0.8","10","12","6","false","20644","33.333333333333336","6","6","false","0","20644","24430263"
"5.32427231176329","0.0","0.18781909366104912","1.0","10","8","4","false","22497","13.5","4","4","false","0","22497","0"
"5.180178012990137","0.0","0.1930435590229405","1.0","10","4","2","false","23387","29.0","2","2","false","0","23387","0"
"5.209766658648063","0.81969082398067","0.19194717643256223","0.6","10","10","5","false","23907","11.6","5","5","false","0","23907","84550858"
"4.629540534038971","34.21449144503476","0.2160041569238763","0.03463203463203463","9","44","22","false","24924","8.909090909090908","22","22","false","0","24924","3205529427"
"4.9160452249218185","2.8509666523371227","0.20341554120180075","0.27472527472527475","10","28","14","false","25080","16.857142857142858","14","14","false","0","25080","334054679"
"5.3228289631946115","0.0","0.18787002304876396","1.0","11","6","3","false","12422","52.0","3","3","false","0","12422","0"
"5.134471974981958","0.14048514732542386","0.1947619940029985","0.7","11","10","5","false","1339","12.0","5","5","false","0","1339","27127807"
"5.393553043059899","0.37486940661465906","0.1854065385130012","0.26666666666666666","11","12","6","false","3164","10.166666666666666","6","6","false","0","3164","56605531"
"4.949723358191003","0.20188085945325246","0.20203149300155523","0.5714285714285714","11","14","7","false","15580","16.857142857142858","7","7","false","0","15580","35250795"
"5.1363964397401976","0.0","0.19468902210565753","1.0","11","8","4","false","16393","13.75","4","4","false","0","16393","0"
"4.295164782294925","32.562458513698445","0.2328199383926071","0.13230769230769232","11","52","26","false","20478","15.846153846153847","26","26","false","0","20478","4582760787"
"5.682463314890546","0.0","0.17598001862670393","0.0","11","2","1","false","20956","17.0","1","1","false","0","20956","0"
"4.700745730093818","7.069716975976381","0.2127322040837214","0.2777777777777778","10","18","9","false","3890","21.666666666666668","9","9","false","0","3890","861003770"
"4.660813086360356","3.6855366526364386","0.2145548387096774","0.6320346320346321","10","44","22","false","5621","20.5","22","22","false","0","5621","466857472"
"5.442145778205437","0.0","0.18375104981655835","1.0","11","4","2","false","8824","16.5","2","2","false","0","8824","0"
"5.236228049073851","0.0","0.19097716727155786","1.0","11","6","3","false","11613","26.0","3","3","false","0","11613","0"
"5.059898965600192","0.0","0.19763240467814017","1.0","10","6","3","false","12306","24.666666666666668","3","3","false","0","12306","0"
"5.23959586240077","0.0","0.1908544143978697","1.0","11","6","3","false","12860","15.333333333333334","3","3","false","0","12860","0"
"5.444070242963676","0.0","0.18368609429543545","0.0","11","2","1","false","14547","27.0","1","1","false","0","14547","0"
"5.3755111859514075","1.6040247042120879","0.18602881947552133","0.3333333333333333","11","6","3","false","18182","12.666666666666666","3","3","false","0","18182","120701502"
"5.23959586240077","0.0","0.1908544143978697","1.0","11","6","3","false","21707","15.333333333333334","3","3","false","0","21707","0"
"4.618955977868655","35.263320398289146","0.21649914066975678","0.11578947368421053","10","40","20","false","24696","9.45","20","20","false","0","24696","3199003167"
"5.430117873466442","0.3374978877160216","0.1841580649448456","0.7142857142857143","11","14","7","false","2661","9.571428571428571","7","7","false","0","2661","55636135"
"5.032715900890065","1.6230933373518894","0.19869987094307154","0.4","10","10","5","false","7899","14.4","5","5","false","0","7899","240977421"
"5.431080105845561","0.0","0.18412543739203616","1.0","11","10","5","false","8067","11.8","5","5","false","0","8067","0"
"5.175847967284099","0.9087579908869836","0.1932050567019892","0.3333333333333333","11","6","3","false","8208","17.0","3","3","false","0","8208","89489473"
"5.430117873466442","0.5331687739121511","0.1841580649448456","0.6666666666666666","11","14","7","false","11132","9.428571428571429","7","7","false","0","11132","44104810"
"5.431080105845561","0.0","0.18412543739203616","1.0","11","8","4","false","11402","13.25","4","4","false","0","11402","0"
"5.425306711570844","0.5642165417297853","0.18432137631357248","0.4642857142857143","11","16","8","false","12980","8.625","8","8","false","0","12980","54344871"
"5.049795525619437","2.7570059253108687","0.19802782012195122","0.25","11","16","8","false","13364","17.0","8","8","false","0","13364","276786266"
"5.430117873466442","5.772472295218884E-4","0.1841580649448456","0.8095238095238095","11","14","7","false","14969","9.857142857142858","7","7","false","0","14969","42772"
"4.542217945633871","13.283983824478497","0.22015676305476115","0.22153846153846155","11","52","26","false","16389","15.76923076923077","26","26","false","0","16389","2135615214"
"5.203993264373346","1.1829097878216355","0.19216012573383257","0.3","11","10","5","false","18109","10.8","5","5","false","0","18109","93186620"
"4.743565070964638","20.622965034997947","0.2108119072975303","0.10989010989010989","11","28","14","false","18365","8.357142857142858","14","14","false","0","18365","2756670017"
"4.432282896319461","44.21553841206523","0.22561736770691995","0.10416666666666667","10","66","33","false","23038","11.393939393939394","33","33","false","0","23038","5162700935"
"5.429877315371662","0.33813770221077316","0.18416622363990784","0.6428571428571429","11","16","8","false","24845","8.75","8","8","false","0","24845","55665232"
"5.3930719268703395","0.0","0.1854230786386547","1.0","11","4","2","false","25379","16.5","2","2","false","0","25379","0"
"4.837863844118354","6.713208104725611","0.20670279946298048","0.2","12","22","11","false","13740","10.727272727272727","11","11","false","0","13740","641189085"
"4.600673562665384","21.270898562143596","0.217359477124183","0.12857142857142856","11","42","21","false","4550","9.80952380952381","21","21","false","0","4550","2088025497"
"5.837382727928794","0.0","0.17130965136404847","1.0","13","4","2","false","4702","6.5","2","2","false","0","4702","0"
"4.754149627134953","9.597257934243874","0.21034255932803725","0.2","11","30","15","false","7264","11.133333333333333","15","15","false","0","7264","1148136623"
"4.356988212653356","54.514088157795236","0.22951634275618374","0.12987012987012986","11","44","22","false","13096","13.909090909090908","22","22","false","0","13096","5008900613"
"5.0307914361318256","0.03548636730292279","0.1987758810309377","0.6666666666666666","12","8","4","false","14128","14.25","4","4","false","0","14128","3780666"
"4.906422901130623","12.004197353512907","0.20381447342616202","0.09166666666666666","11","32","16","false","19489","10.9375","16","16","false","0","19489","1089536879"
"5.2165022853019005","0.7241438073809854","0.1916993313350242","0.5","11","8","4","false","19527","15.0","4","4","false","0","19527","69706055"
"5.837382727928794","0.0","0.17130965136404847","1.0","13","4","2","false","19784","6.5","2","2","false","0","19784","0"
"4.678614385374068","6.06565429594078","0.21373849555247054","0.47619047619047616","11","14","7","false","22476","23.0","7","7","false","0","22476","842399073"
"4.273514553764734","38.50149976748836","0.23399943709541232","0.1341991341991342","11","44","22","false","25006","15.636363636363637","22","22","false","0","25006","4233555361"
"5.777724320423382","1.4443896451457185","0.17307852444000332","0.0","12","6","3","false","25486","6.666666666666667","3","3","false","0","25486","131122726"
"5.035602598027424","0.0","0.19858596474466153","1.0","11","10","5","false","26","17.6","5","5","false","0","26","0"
"5.027183064710128","0.24256933516980747","0.19891855679969372","0.7333333333333333","11","12","6","false","1407","15.833333333333334","6","6","false","0","1407","31134551"
"4.4204955496752465","50.70895308769774","0.22621898127993034","0.08172043010752689","10","62","31","false","1488","10.225806451612904","31","31","false","0","1488","4798269918"
"5.108010584556171","0.0","0.19577093340868418","1.0","11","4","2","false","8219","25.0","2","2","false","0","8219","0"
"4.396680298292037","57.68817579194321","0.22744432893800953","0.07586206896551724","11","60","30","false","10762","9.333333333333334","30","30","false","0","10762","5398126107"
"4.931200384892952","6.3539315810469885","0.2027903800185375","0.23636363636363636","11","22","11","false","11801","10.909090909090908","11","11","false","0","11801","673113283"
"5.356747654558576","0.0","0.18668043829710795","0.0","12","2","1","false","12665","22.0","1","1","false","0","12665","0"
"5.062785662737551","0.0","0.1975197187113941","1.0","11","6","3","false","12688","22.333333333333332","3","3","false","0","12688","0"
"4.424585037286505","51.43210623338299","0.22600989506877614","0.08994708994708994","10","56","28","false","13142","10.321428571428571","28","28","false","0","13142","5277626151"
"4.755592975703633","26.64815171129365","0.210278719206839","0.06493506493506493","11","44","22","false","15108","7.0","22","22","false","0","15108","2217614913"
"5.071445754149627","4.284926200906007","0.19718243050943934","0.2","11","10","5","false","15321","12.8","5","5","false","0","15321","351553267"
"5.341833052682222","0.8350308527885546","0.18720165720976314","0.3333333333333333","12","6","3","false","20647","9.0","3","3","false","0","20647","62238243"
"4.794082270868414","20.913216021835566","0.20859049626172915","0.17857142857142858","10","16","8","false","20827","15.75","8","8","false","0","20827","2407359218"
"4.7748376232860235","17.93444242310807","0.20943120560229736","0.12380952380952381","11","30","15","false","20879","10.066666666666666","15","15","false","0","20879","1633796965"
"4.8008178975222515","37.556643401443566","0.20829784035676704","0.13538461538461538","11","52","26","false","23614","8.923076923076923","26","26","false","0","23614","3568588273"
"4.6860716863122445","18.98981325178701","0.21339835728952772","0.11029411764705882","11","34","17","false","3909","9.823529411764707","17","17","false","0","3909","1937738398"
"5.092133750300698","1.7851082372910898","0.19638133030990174","0.3","10","10","5","false","17979","8.4","5","5","false","0","17979","124862940"
"5.833293240317537","5.050235550470068","0.1714297496803992","0.17857142857142858","11","16","8","false","3872","5.75","8","8","false","0","3872","1430877119"
"6.832812124127977","0.0","0.1463526263906492","1.0","12","4","2","false","5109","5.5","2","2","false","0","5109","0"
"5.147462112100072","2.2428462272092125","0.19427049256939902","0.5","10","16","8","false","7533","25.625","8","8","false","0","7533","616802802"
"6.627616069280731","0.03395286008530715","0.15088381546949295","0.6666666666666666","12","6","3","false","12409","4.666666666666667","3","3","false","0","12409","6982841"
"6.833052682222757","0.0","0.14634747403626122","0.0","12","2","1","false","20101","8.0","1","1","false","0","20101","0"
"6.833052682222757","0.0","0.14634747403626122","0.0","12","2","1","false","23096","8.0","1","1","false","0","23096","0"
"5.365648304065432","3.6387884769016057","0.18637076888590004","0.2857142857142857","11","14","7","false","8862","8.285714285714286","7","7","false","0","8862","342616662"
"5.783738272792879","1.0095715099598022","0.17289855675248514","0.5","11","8","4","false","78","9.25","4","4","false","0","78","65362169"
"5.670194852056771","0.0","0.17636078231725427","1.0","12","6","3","false","4877","8.0","3","3","false","0","4877","0"
"4.708924705316334","19.808723597231122","0.21236270753512132","0.2878787878787879","11","24","12","false","7459","13.916666666666666","12","12","false","0","7459","2148280519"
"5.230935770988694","10.828344376655583","0.191170383996321","0.11538461538461539","11","26","13","false","8254","4.923076923076923","13","13","false","0","8254","853915242"
"6.034159249458744","0.0","0.1657231701483017","1.0","12","6","3","false","12155","8.0","3","3","false","0","12155","0"
"4.6680298292037525","23.6377532846844","0.21422313836640042","0.1830065359477124","10","36","18","false","22598","11.944444444444445","18","18","false","0","22598","2321140088"
"5.666827038729854","16.907922858413617","0.17646559409092838","0.4","12","10","5","false","24932","5.8","5","5","false","0","24932","1847839153"
"5.211450565311523","0.0","0.1918851550960118","1.0","11","12","6","false","888","15.333333333333334","6","6","false","0","888","0"
"5.211450565311523","0.0","0.1918851550960118","1.0","11","12","6","false","1520","15.333333333333334","6","6","false","0","1520","0"
"5.031753668510945","7.738251104467425","0.1987378687192236","0.3333333333333333","11","12","6","false","6468","16.0","6","6","false","0","6468","639038001"
"5.640365648304066","0.0","0.17729347038000595","1.0","11","6","3","false","6627","10.0","3","3","false","0","6627","0"
"4.556410873225884","50.46469821669503","0.21947098886014466","0.1","10","50","25","false","7007","8.8","25","25","false","0","7007","3870970933"
"4.726244888140486","10.877112893276026","0.21158446582175397","0.1830065359477124","10","36","18","false","7712","10.333333333333334","18","18","false","0","7712","1154484967"
"4.740437815732499","24.350201556392594","0.21095097939713792","0.11462450592885376","11","46","23","false","10711","8.826086956521738","23","23","false","0","10711","2369540211"
"4.682944431080106","17.695090739472832","0.21354086402630093","0.25","11","32","16","false","13614","11.375","16","16","false","0","13614","1518032583"
"5.0226124609093095","3.0468535527018044","0.19909957373437426","0.42857142857142855","11","14","7","false","14102","12.857142857142858","7","7","false","0","14102","224900372"
"4.974019725763772","1.0131416081987343","0.20104463897083716","0.4166666666666667","11","18","9","false","18517","13.444444444444445","9","9","false","0","18517","171213996"
"5.52128939138802","3.9843475393788554","0.18111711397699548","0.25","11","18","9","false","18676","5.555555555555555","9","9","false","0","18676","297909582"
"5.13110416165504","0.45858630700142866","0.19488982653539613","0.6388888888888888","11","18","9","false","23351","12.444444444444445","9","9","false","0","23351","68456299"
"5.640365648304066","0.0","0.17729347038000595","1.0","11","6","3","false","23689","10.0","3","3","false","0","23689","0"
"5.667789271108973","0.0","0.176435635159798","0.0","11","2","1","false","24114","18.0","1","1","false","0","24114","0"
"5.273755111859514","2.592762092043061","0.1896182091866989","0.5","11","8","4","false","2465","12.25","4","4","false","0","2465","182348071"
"6.0837142169834015","0.0","0.16437327006722025","1.0","12","4","2","false","2592","10.0","2","2","false","0","2592","0"
"5.30454654799134","3.0065138905075797","0.188517527549771","0.2857142857142857","11","14","7","false","3977","7.0","7","7","false","0","3977","292911695"
"6.230695212893914","0.0","0.16049573375545345","0.0","12","2","1","false","5055","13.0","1","1","false","0","5055","0"
"4.668751503488092","14.31010936354717","0.21419002473206925","0.1282051282051282","11","26","13","false","5993","11.692307692307692","13","13","false","0","5993","1237418124"
"6.230695212893914","0.0","0.16049573375545345","0.0","12","2","1","false","9265","13.0","1","1","false","0","9265","0"
"4.840028866971374","19.93361036739203","0.206610337972167","0.1282051282051282","10","26","13","false","12334","9.23076923076923","13","13","false","0","12334","2405065091"
"5.969449121962954","3.509725131763092","0.16751964537578076","0.13333333333333333","12","12","6","false","19890","4.833333333333333","6","6","false","0","19890","307021109"
"6.230695212893914","0.0","0.16049573375545345","0.0","12","2","1","false","20341","13.0","1","1","false","0","20341","0"
"6.1991821024777485","0.0","0.1613116026387272","1.0","12","4","2","false","21560","9.5","2","2","false","0","21560","0"
"6.502044743805629","0.0","0.15379777276258833","0.0","13","2","1","false","17309","17.0","1","1","false","0","17309","0"
"5.502285301900409","12.191360314172991","0.18174266602544484","0.18382352941176472","12","34","17","false","24833","8.529411764705882","17","17","false","0","24833","947061424"
"5.3408708203031035","12.794626253846642","0.18723538419962166","0.16666666666666666","12","48","24","false","543","8.666666666666666","24","24","false","0","543","1125891544"
"4.996632186673081","21.642911400539113","0.20013480333156805","0.25146198830409355","11","38","19","false","1958","11.31578947368421","19","19","false","0","1958","1957688061"
"5.80466682703873","0.035173599111137384","0.17227517612929963","0.8666666666666667","12","12","6","false","2193","14.666666666666666","6","6","false","0","2193","6122707"
"6.267981717584797","0.0","0.15954098863985264","1.0","13","6","3","false","3917","10.0","3","3","false","0","3917","0"
"6.501563627616069","0.0","0.1538091538091538","1.0","13","6","3","false","6858","7.666666666666667","3","3","false","0","6858","0"
"6.501563627616069","0.0","0.1538091538091538","1.0","13","6","3","false","8148","7.666666666666667","3","3","false","0","8148","0"
"5.606446956940101","0.4265336133758601","0.17836608598644124","0.6666666666666666","12","6","3","false","9092","16.666666666666668","3","3","false","0","9092","39173803"
"5.642530671157084","9.20212269357129","0.17722544338335608","0.24444444444444444","12","20","10","false","12478","7.2","10","10","false","0","12478","746274445"
"6.501563627616069","0.0","0.1538091538091538","1.0","13","6","3","false","15366","7.666666666666667","3","3","false","0","15366","0"
"5.789271108972817","0.0","0.1727333167123743","1.0","12","6","3","false","18125","19.666666666666668","3","3","false","0","18125","0"
"6.267981717584797","0.0","0.15954098863985264","1.0","13","6","3","false","18398","10.0","3","3","false","0","18398","0"
"5.554005292278085","0.7408652248849342","0.18005024255024255","0.275","12","32","16","false","19675","8.8125","16","16","false","0","19675","76704960"
"6.197738753909069","7.018212737406452","0.16134916938363608","0.2","13","12","6","false","21806","7.0","6","6","false","0","21806","560262071"
"5.528987250420976","0.4206659856803637","0.18086494953010793","0.7222222222222222","12","18","9","false","23693","13.777777777777779","9","9","false","0","23693","67810770"
"5.80442626894395","0.038039856386834714","0.17228231588544904","0.8571428571428571","12","14","7","false","26196","13.428571428571429","7","7","false","0","26196","6470415"
"1.0","2.5","1.0","0.0","1","4","2","false","10115","1.0","2","2","false","0","10115","5"
"1.5","0.0","0.6666666666666666","0.0","2","2","1","false","10134","2.0","1","1","false","0","10134","0"
"1.5","0.0","0.6666666666666666","0.0","2","2","1","false","23916","2.0","1","1","false","0","23916","0"
"5.4784700505172","5.963941194031183","0.18253271274260122","0.3888888888888889","11","18","9","false","7893","10.0","9","9","false","0","7893","1572760182"
"6.28241520327159","4.984015011413816","0.15917445244294684","0.4","12","32","16","false","593","8.0625","16","16","false","0","593","1396131555"
"5.625932162617272","3.7408530656840817","0.17774832171719332","0.19047619047619047","11","14","7","false","5510","8.428571428571429","7","7","false","0","5510","835882032"
"4.941544382968487","16.43512390713428","0.20236588452925713","0.17777777777777778","10","20","10","false","9360","13.0","10","10","false","0","9360","2325661724"
"6.426028385855184","3.6745544449371286","0.15561711526223188","0.44761904761904764","12","30","15","false","12627","8.266666666666667","15","15","false","0","12627","1163877969"
"6.243444791917248","1.869459130111012","0.16016798951991984","0.6071428571428571","12","16","8","false","16778","10.375","8","8","false","0","16778","502718014"
"5.571806591291797","0.0","0.1794750021587082","1.0","11","6","3","false","18037","10.666666666666666","3","3","false","0","18037","0"
"5.47822949242242","8.541048651961411","0.18254072805515303","0.26666666666666666","11","20","10","false","18051","8.8","10","10","false","0","18051","1769008881"
"6.47798893432764","0.0","0.15436889598574027","0.0","12","2","1","false","13385","10.0","1","1","false","0","13385","0"
"6.47798893432764","0.0","0.15436889598574027","0.0","12","2","1","false","19578","10.0","1","1","false","0","19578","0"
"7.1284580226124605","0.0","0.14028279283231535","1.0","13","10","5","false","12386","11.8","5","5","false","0","12386","0"
"7.1284580226124605","0.0","0.14028279283231535","1.0","13","10","5","false","13333","11.8","5","5","false","0","13333","0"
"6.736829444310801","1.9225486647532097","0.14843777896804142","0.4095238095238095","12","30","15","false","23896","7.466666666666667","15","15","false","0","23896","361497900"
"6.0396920856386815","0.0","0.16557135460230216","1.0","12","8","4","false","8978","13.5","4","4","false","0","8978","0"
"5.1811402453692565","21.428569373130333","0.19300770730801375","0.13756613756613756","11","56","28","false","9017","8.035714285714286","28","28","false","0","9017","2123167187"
"6.0396920856386815","0.0","0.16557135460230216","1.0","12","8","4","false","15170","13.5","4","4","false","0","15170","0"
"5.266538369016118","12.358436740442837","0.18987804321015847","0.22794117647058823","11","34","17","false","15455","10.470588235294118","17","17","false","0","15455","1425904568"
"6.039210969449122","1.1503526562754858","0.16558454491137226","0.6","12","10","5","false","16589","11.2","5","5","false","0","16589","173384993"
"5.940101034399808","1.1777874161787731","0.16834730490422387","0.3","12","10","5","false","2255","10.8","5","5","false","0","2255","84325233"
"5.998075535241761","0.0","0.1667201411726959","1.0","12","6","3","false","3056","21.333333333333332","3","3","false","0","3056","0"
"6.04257878277604","0.0","0.16549225685735897","1.0","12","8","4","false","6158","15.75","4","4","false","0","6158","0"
"4.8272792879480395","42.30042459237158","0.20715602730851645","0.1076923076923077","11","52","26","false","7307","8.73076923076923","26","26","false","0","7307","4404936372"
"5.671157084435891","1.5670744124801397","0.17633085896076353","0.5","11","8","4","false","7324","15.5","4","4","false","0","7324","149507920"
"5.339186913639644","3.6242368945951906","0.18729443568371257","0.3333333333333333","11","24","12","false","8365","12.0","12","12","false","0","8365","488788769"
"6.180899687274477","0.0","0.16178874445395813","0.0","12","2","1","false","9023","28.0","1","1","false","0","9023","0"
"6.1462593216261725","0.8464726251531745","0.16270058708414872","0.3333333333333333","12","6","3","false","11444","12.0","3","3","false","0","11444","140976911"
"5.691604522492182","0.5775000998044526","0.1756973795435334","0.6","12","10","5","false","12324","15.4","5","5","false","0","12324","74977813"
"5.52128939138802","8.559107728283015","0.18111711397699548","0.2545454545454545","11","22","11","false","12472","11.181818181818182","11","11","false","0","12472","733684872"
"5.350733702189078","3.96407868680173","0.18689025760913547","0.26666666666666666","11","32","16","false","13831","10.9375","16","16","false","0","13831","607277738"
"4.579985566514313","51.61634225878571","0.21834129943799568","0.08","10","50","25","false","14746","9.48","25","25","false","0","14746","4296974131"
"5.4784700505172","0.07083363190854096","0.18253271274260122","0.8333333333333334","11","8","4","false","16128","20.25","4","4","false","0","16128","13675712"
"5.433485686793361","13.930099673072114","0.1840439190684907","0.14619883040935672","11","38","19","false","17075","7.7368421052631575","19","19","false","0","17075","1355805664"
"5.732499398604763","4.181697857220749","0.17444397817876625","0.25","11","16","8","false","18875","9.375","8","8","false","0","18875","305059725"
"5.9961510704835215","1.5205086588163466","0.16677365000401187","0.3333333333333333","12","8","4","false","19900","14.5","4","4","false","0","19900","133066644"
"5.424585037286505","1.9863281126772414","0.18434589800443457","0.3","11","10","5","false","20000","13.6","5","5","false","0","20000","184336247"
"6.072407986528747","0.0","0.16467931703838687","1.0","11","4","2","false","20806","18.0","2","2","false","0","20806","0"
"5.692085638681742","0.0","0.17568252894937028","1.0","12","8","4","false","21944","18.75","4","4","false","0","21944","0"
"5.296127014674044","12.287417460548905","0.1888172238372093","0.20512820512820512","11","26","13","false","21968","10.923076923076923","13","13","false","0","21968","1424890319"
"5.480153957180659","0.0","0.18247662525789035","1.0","11","6","3","false","23302","21.666666666666668","3","3","false","0","23302","0"
"5.991821024777484","8.182480711844825","0.1668941705476152","0.24242424242424243","12","24","12","false","23665","8.916666666666666","12","12","false","0","23665","1272026229"
"6.072407986528747","0.0","0.16467931703838687","1.0","11","4","2","false","23758","18.0","2","2","false","0","23758","0"
"6.04257878277604","0.0","0.16549225685735897","1.0","12","8","4","false","24722","15.75","4","4","false","0","24722","0"
"6.266297810921338","0.0","0.1595838611846904","0.0","12","2","1","false","12045","17.0","1","1","false","0","12045","0"
"5.637719509261487","0.0","0.17737668544120155","1.0","11","6","3","false","12287","14.666666666666666","3","3","false","0","12287","0"
"5.34736588886216","17.5673885833601","0.18700796257141572","0.17777777777777778","12","20","10","false","14181","13.0","10","10","false","0","14181","1722144250"
"6.08587923983642","0.05315829342239051","0.1643147950511878","0.6666666666666666","12","6","3","false","20257","9.666666666666666","3","3","false","0","20257","7977304"
"7.008419533317296","0.7077952225486516","0.14268552207043317","0.0","13","6","3","false","21613","3.0","3","3","false","0","21613","110962743"
"5.9689680057733945","0.0","0.16753314794664087","1.0","11","4","2","false","7510","6.5","2","2","false","0","7510","0"
"5.9689680057733945","0.0","0.16753314794664087","1.0","11","4","2","false","197","6.5","2","2","false","0","197","0"
"4.969449121962954","11.113047568773428","0.20122954787491526","0.07272727272727272","10","22","11","false","8851","7.636363636363637","11","11","false","0","8851","919476602"
"5.9689680057733945","0.0","0.16753314794664087","1.0","11","6","3","false","1343","6.5","3","2","false","1","1343","0"
"5.76040413759923","0.32957537710008644","0.17359893092792117","0.0","11","4","2","false","2991","10.5","2","2","false","0","2991","29375413"
"5.9692085638681744","0.0","0.16752639638913516","0.0","11","2","1","false","8299","11.0","1","1","false","0","8299","0"
"5.9689680057733945","0.0","0.16753314794664087","1.0","11","4","2","false","15416","6.5","2","2","false","0","15416","0"
"5.43516959345682","3.0141776536340554","0.1839868991767726","0.2857142857142857","11","16","8","false","18088","6.25","8","8","false","0","18088","226433877"
"5.309357709886938","6.244743186826824","0.18834669928865932","0.15384615384615385","11","26","13","false","25286","7.076923076923077","13","13","false","0","25286","643250082"
"5.169834014914602","0.36457209099687066","0.19342980782653205","0.3333333333333333","10","6","3","false","1254","20.666666666666668","3","3","false","0","1254","53259908"
"5.002405580947799","1.7017926275579678","0.19990382303438328","0.3333333333333333","10","6","3","false","3420","22.666666666666668","3","3","false","0","3420","160706695"
"4.560500360837143","20.46933724766229","0.21927418504061608","0.12380952380952381","10","30","15","false","10130","12.133333333333333","15","15","false","0","10130","1910024390"
"4.842434447919173","0.0","0.2065076999503229","1.0","10","34","17","false","2250","22.941176470588236","17","17","false","0","2250","0"
"5.161655039692086","1.0875123017590702","0.19373630982896023","0.0","11","6","3","false","3243","16.333333333333332","3","3","false","0","3243","93041946"
"4.842434447919173","0.0","0.2065076999503229","1.0","10","34","17","false","7717","22.941176470588236","17","17","false","0","7717","0"
"4.776280971854703","22.563271955558967","0.20936791740115837","0.14285714285714285","10","30","15","false","7985","9.533333333333333","15","15","false","0","7985","2036372867"
"4.698099591051239","5.66426383461488","0.21285202252944188","0.6233766233766234","10","44","22","false","11015","21.545454545454547","22","22","false","0","11015","760655992"
"4.664421457782054","2.236352929321194","0.21438886023723572","0.3055555555555556","10","18","9","false","12085","31.555555555555557","9","9","false","0","12085","377493983"
"4.842434447919173","0.0","0.2065076999503229","1.0","10","34","17","false","13714","22.941176470588236","17","17","false","0","13714","0"
"4.842434447919173","0.0","0.2065076999503229","1.0","10","34","17","false","14767","22.941176470588236","17","17","false","0","14767","0"
"4.770748135674766","14.40501097580364","0.20961073013311818","0.07575757575757576","9","24","12","false","16056","8.833333333333334","12","12","false","0","16056","1323556883"
"4.504209766658648","36.49109312572845","0.22201452681051057","0.12631578947368421","10","40","20","false","16994","10.3","20","20","false","0","16994","3423142813"
"4.936252104883329","6.947987790172941","0.20258284600389864","0.1388888888888889","10","18","9","false","17414","11.555555555555555","9","9","false","0","17414","825996117"
"4.842434447919173","0.0","0.2065076999503229","1.0","10","34","17","false","18971","22.941176470588236","17","17","false","0","18971","0"
"4.842434447919173","0.0","0.2065076999503229","1.0","10","34","17","false","19216","22.941176470588236","17","17","false","0","19216","0"
"4.842434447919173","0.0","0.2065076999503229","1.0","10","34","17","false","20534","22.941176470588236","17","17","false","0","20534","0"
"4.902333413519365","6.463839934332623","0.20398449384169978","0.3","10","10","5","false","21776","19.0","5","5","false","0","21776","562676312"
"5.184026942506615","2.593878598756841","0.1929002320185615","0.75","11","16","8","false","21860","17.75","8","8","false","0","21860","405195688"
"4.842434447919173","0.0","0.2065076999503229","1.0","10","34","17","false","25205","22.941176470588236","17","17","false","0","25205","0"
"4.984363723839307","3.101752482930933","0.20062741312741314","0.2857142857142857","10","16","8","false","178","9.0","8","8","false","0","178","289764922"
"5.291556410873226","0.4588332853339838","0.18898031549756786","0.3333333333333333","11","6","3","false","1248","8.666666666666666","3","3","false","0","1248","37935331"
"4.91339908587924","4.1690566863410226","0.20352509179926562","0.23809523809523808","11","14","7","false","1403","10.428571428571429","7","7","false","0","1403","374423361"
"4.776280971854703","8.53420327743058","0.20936791740115837","0.16666666666666666","10","18","9","false","2368","9.88888888888889","9","9","false","0","2368","939496559"
"5.225884050998316","4.033601844633737","0.1913551832075124","0.3","11","10","5","false","2420","11.4","5","5","false","0","2420","358943413"
"4.731296608130863","8.488952364569558","0.21135855196257883","0.11538461538461539","11","26","13","false","16210","13.461538461538462","13","13","false","0","16210","937105596"
"5.148183786384412","1.0456787000537753","0.1942432596607635","0.3333333333333333","11","6","3","false","18681","24.333333333333332","3","3","false","0","18681","125707077"
"5.425066153476065","0.0","0.18432954948563318","1.0","11","4","2","false","20641","11.5","2","2","false","0","20641","0"
"5.327159008900649","2.54211207129696","0.18771731767893432","0.3333333333333333","11","8","4","false","24762","9.0","4","4","false","0","24762","210074408"
"5.319461149867693","0.0","0.18798896576674354","1.0","11","4","2","false","2307","23.0","2","2","false","0","2307","0"
"4.629540534038971","14.79258652139624","0.2160041569238763","0.0989010989010989","10","28","14","false","6934","12.428571428571429","14","14","false","0","6934","1559929550"
"5.599951888381044","8.929107135869943","0.17857296275613213","0.875","11","32","16","false","22423","15.0625","16","16","false","0","22423","787127910"
"4.590570122684628","26.797982127814542","0.21783786616360112","0.24367816091954023","10","60","30","false","231","23.933333333333334","30","30","false","0","231","4480093357"
"4.71734423863363","0.9255849164028576","0.21198368179500254","0.46153846153846156","11","26","13","false","345","37.0","13","13","false","0","345","246871596"
"4.855424585037286","4.057496485472315","0.20595521204914785","0.4338235294117647","10","34","17","false","1186","30.058823529411764","17","17","false","0","1186","759729250"
"4.793120038489295","8.43555969730548","0.2086323713927227","0.6190476190476191","11","14","7","false","1234","31.714285714285715","7","7","false","0","1234","1356702611"
"5.172239595862401","0.0","0.193339844658388","1.0","11","12","6","false","1841","28.0","6","6","false","0","1841","0"
"5.139283136877556","0.0","0.19457966672907695","1.0","11","16","8","false","1997","55.75","8","8","false","0","1997","0"
"5.1989415443829685","1.0471198503617385","0.19234684434573385","0.5","11","16","8","false","2404","27.875","8","8","false","0","2404","173715114"
"5.175607409189319","0.0","0.19321403671856843","1.0","11","4","2","false","2450","55.5","2","2","false","0","2450","0"
"4.709646379600674","3.9757964078950008","0.21233016651343345","0.35507246376811596","10","48","24","false","2980","28.0","24","24","false","0","2980","768340584"
"4.860235746932884","2.5949474024980694","0.20575133636903586","0.39166666666666666","10","32","16","false","3409","31.875","16","16","false","0","3409","566888791"
"5.072407986528747","0.020440087635078708","0.19714502513516077","0.8095238095238095","11","14","7","false","5134","44.42857142857143","7","7","false","0","5134","3868092"
"4.949001683906664","0.0","0.20206095367714966","1.0","11","14","7","false","5578","39.42857142857143","7","7","false","0","5578","0"
"4.772191484243445","8.088055398270978","0.2095473334005444","0.26373626373626374","10","28","14","false","8503","30.071428571428573","14","14","false","0","8503","1203800922"
"5.147702670194852","0.0","0.1942614140847703","1.0","11","8","4","false","9341","65.25","4","4","false","0","9341","0"
"4.620639884532115","24.617982542112607","0.21642024156601414","0.1736842105263158","10","40","20","false","9889","22.0","20","20","false","0","9889","5498808478"
"5.055087803704595","0.045006728356907416","0.19782050061863518","0.75","11","18","9","false","12503","30.77777777777778","9","9","false","0","12503","18584635"
"5.139042578782776","4.9554330821326456E-5","0.19458877498478677","0.9722222222222222","11","18","9","false","13060","54.888888888888886","9","9","false","0","13060","6849"
"4.724320423382247","22.594188579962484","0.2116706553286827","0.25","10","34","17","false","13597","21.41176470588235","17","17","false","0","13597","2889852812"
"5.172239595862401","0.0","0.193339844658388","1.0","11","12","6","false","16611","28.0","6","6","false","0","16611","0"
"4.656723598749098","38.25181661688237","0.21474325860109517","0.08333333333333333","10","48","24","false","18208","12.0","24","24","false","0","18208","5104349592"
"5.150108251142651","3.998895848508029","0.19417067588397402","0.42857142857142855","11","16","8","false","18543","22.375","8","8","false","0","18543","570328815"
"4.345922540293481","51.93790535797474","0.2301007417247869","0.20824524312896406","10","88","44","false","18866","26.295454545454547","44","44","false","0","18866","8466511843"
"5.199422660572528","0.07751706228963065","0.192329045988711","0.8","11","12","6","false","22421","28.833333333333332","6","6","false","0","22421","20102354"
"4.80394515275439","2.757561551260491","0.20816224336504757","0.4117647058823529","10","36","18","false","22937","24.72222222222222","18","18","false","0","22937","477932592"
"4.9865287466923265","1.621327484750071","0.20054030585170532","0.4666666666666667","10","20","10","false","23363","26.4","10","10","false","0","23363","245465152"
"5.141929275920135","0.0","0.19447953216374267","1.0","11","12","6","false","23628","57.333333333333336","6","6","false","0","23628","0"
"4.8188597546307435","0.6996194944616803","0.20751797124600638","0.5833333333333334","11","18","9","false","25053","26.22222222222222","9","9","false","0","25053","144507982"
"5.067837382727928","0.0","0.19732282717045618","1.0","11","4","2","false","25251","73.5","2","2","false","0","25251","0"
"5.159730574933847","0.0","0.19380856916406358","1.0","11","6","3","false","2982","40.333333333333336","3","3","false","0","2982","0"
"5.258840509983161","2.1949177100451354","0.19015598554503454","0.3333333333333333","11","6","3","false","4036","28.333333333333332","3","3","false","0","4036","176163483"
"5.291796968968006","2.3928468811840837E-4","0.18897172470224566","0.8","11","10","5","false","4115","20.0","5","5","false","0","4115","12402"
"5.259802742362281","0.024792473382322502","0.19012119826206264","0.5357142857142857","11","16","8","false","12938","14.0","8","8","false","0","12938","3806538"
"5.28361799374549","0.0","0.1892642505918776","1.0","11","4","2","false","13032","40.0","2","2","false","0","13032","0"
"5.292518643252345","0.0","0.18894595700195446","1.0","11","4","2","false","19215","42.5","2","2","false","0","19215","0"
"4.533317296127015","18.530292889891996","0.22058901565401964","0.16339869281045752","11","36","18","false","21432","15.61111111111111","18","18","false","0","21432","2627019787"
"5.292278085157566","0.0","0.18895454545454543","1.0","11","6","3","false","22726","31.0","3","3","false","0","22726","0"
"4.961270146740437","0.19933638089481162","0.20156128782001553","0.7333333333333333","11","12","6","false","22834","24.0","6","6","false","0","22834","29439166"
"5.2607649747414005","0.0","0.1900864237047876","1.0","11","8","4","false","22966","25.25","4","4","false","0","22966","0"
"5.292037527062786","0.0","0.18896313468794035","1.0","11","8","4","false","23511","24.5","4","4","false","0","23511","0"
"5.292278085157566","0.0","0.18895454545454543","1.0","11","6","3","false","25528","30.0","3","3","false","0","25528","0"
"5.259802742362281","0.02511383403369467","0.19012119826206264","0.5","11","16","8","false","25836","13.875","8","8","false","0","25836","3815489"
"5.709405821505894","0.0","0.1751495744501559","0.0","11","2","1","false","14376","24.0","1","1","false","0","14376","0"
"6.0012027904739","0.0","0.16663326251653504","1.0","12","4","2","false","8710","6.5","2","2","false","0","8710","0"
"5.9162857830165985","2.95764638905639","0.1690249654387249","0.10714285714285714","12","16","8","false","22483","2.5","8","8","false","0","22483","209797769"
"5.19509261486649","1.3418131991147275","0.19248934987960734","0.0","11","4","2","false","1375","17.5","2","2","false","0","1375","88304046"
"4.71662256434929","16.317130647724056","0.21201611669301781","0.09166666666666666","10","32","16","false","2846","8.5","16","16","false","0","2846","1347345997"
"4.780611017560741","3.0599926643694495","0.20917828209127964","0.35714285714285715","10","16","8","false","5555","16.5","8","8","false","0","5555","336470445"
"4.781332691845081","6.442063694105894","0.209146709599517","0.3111111111111111","10","20","10","false","5564","13.6","10","10","false","0","5564","594067241"
"4.691845080586962","8.2828966522186","0.2131357670221493","0.14285714285714285","10","16","8","false","5787","18.5","8","8","false","0","5787","923464413"
"5.19509261486649","1.2381580126335832","0.19248934987960734","0.0","11","4","2","false","9721","17.5","2","2","false","0","9721","81363229"
"5.19557373105605","0.0","0.1924715251412168","0.0","11","2","1","false","10158","34.0","1","1","false","0","10158","0"
"4.676449362521049","11.014397931414775","0.2138374485596708","0.3090909090909091","10","22","11","false","10942","14.181818181818182","11","11","false","0","10942","1164855167"
"5.19533317296127","0.0","0.19248043709774507","1.0","11","4","2","false","13600","18.0","2","2","false","0","13600","0"
"4.36925667548713","73.22275432122554","0.2288718823982822","0.07474747474747474","11","90","45","false","13929","10.155555555555555","45","45","false","0","13929","8265420058"
"4.819340870820303","15.092295988300902","0.20749725466706598","0.1","10","32","16","false","21075","7.625","16","16","false","0","21075","1219155759"
"5.19557373105605","0.0","0.1924715251412168","0.0","11","2","1","false","21316","34.0","1","1","false","0","21316","0"
"5.19557373105605","0.0","0.1924715251412168","0.0","11","2","1","false","22900","34.0","1","1","false","0","22900","0"
"4.822949242242001","6.228728908580772","0.20734201207042746","0.26666666666666666","11","20","10","false","23637","12.7","10","10","false","0","23637","567174803"
"4.6771710368053885","16.158797439531213","0.21380445404515763","0.15555555555555556","11","20","10","false","23770","14.6","10","10","false","0","23770","1387703224"
"5.101996632186673","0.2790200375058129","0.19600169739261633","0.0","10","4","2","false","25143","20.5","2","2","false","0","25143","38694418"
"5.19557373105605","0.0","0.1924715251412168","0.0","11","2","1","false","25601","34.0","1","1","false","0","25601","0"
"5.19533317296127","0.0","0.19248043709774507","1.0","11","4","2","false","25980","18.0","2","2","false","0","25980","0"
"6.3762328602357465","0.0","0.15683241530219574","0.0","12","2","1","false","17394","8.0","1","1","false","0","17394","0"
"5.3764734183305265","3.0121188430786123","0.18599552572706937","0.5714285714285714","11","16","8","false","18924","8.375","8","8","false","0","18924","284148255"
"5.263411113783979","14.23424865450469","0.18999085923217549","0.20588235294117646","11","34","17","false","3113","5.882352941176471","17","17","false","0","3113","998681948"
"6.072167428433967","1.1111756368133068","0.16468584105855322","0.7142857142857143","12","14","7","false","8312","7.285714285714286","7","7","false","0","8312","106309513"
"6.072407986528747","0.0","0.16467931703838687","1.0","12","12","6","false","10765","8.5","6","6","false","0","10765","0"
"6.072407986528747","0.0","0.16467931703838687","1.0","12","12","6","false","17538","8.5","6","6","false","0","17538","0"
"6.072407986528747","0.0","0.16467931703838687","1.0","12","12","6","false","25978","8.5","6","6","false","0","25978","0"
"5.7033918691363965","5.280087295596941","0.17533426125100174","0.17857142857142858","12","16","8","false","1172","7.875","8","8","false","0","1172","390830411"
"6.481356747654559","0.0","0.15428868351705452","0.0","12","2","1","false","5674","6.0","1","1","false","0","5674","0"
"6.140004811161895","0.0","0.1628663218931202","1.0","12","4","2","false","26194","6.5","2","2","false","0","26194","0"
"6.422901130623045","0.0","0.15569288389513108","0.0","12","2","1","false","375","7.0","1","1","false","0","375","0"
"6.123646860716863","0.0","0.16330138277812697","1.0","12","4","2","false","1838","8.5","2","2","false","0","1838","0"
"5.5001202790473895","6.371336459036136","0.18181420573827853","0.17777777777777778","12","20","10","false","12733","7.9","10","10","false","0","12733","562586009"
"4.845802261246091","7.414989320114275","0.2063641779189833","0.22727272727272727","10","24","12","false","7188","10.5","12","12","false","0","7188","880353534"
"5.245609814770267","0.24946976436644533","0.190635604879391","0.7","11","10","5","false","896","16.2","5","5","false","0","896","61184707"
"5.845321145056531","0.0","0.171076999053459","1.0","11","4","2","false","921","7.5","2","2","false","0","921","0"
"5.344479191724801","0.0","0.18710897060809292","1.0","11","6","3","false","1508","20.333333333333332","3","3","false","0","1508","0"
"5.344479191724801","0.23816652193713925","0.18710897060809292","0.6666666666666666","11","6","3","false","6815","19.333333333333332","3","3","false","0","6815","51928547"
"5.3230695212893915","0.004715394772990216","0.18786153289949384","0.6666666666666666","11","6","3","false","7209","26.0","3","3","false","0","7209","664148"
"5.343998075535242","0.16602827351951757","0.1871258158901643","0.7","11","10","5","false","8279","13.4","5","5","false","0","8279","51859063"
"4.680298292037527","12.956400916052962","0.21366159539473684","0.15204678362573099","10","38","19","false","13008","9.526315789473685","19","19","false","0","13008","1283759682"
"5.845561703151311","0.0","0.17106995884773663","0.0","11","2","1","false","18605","12.0","1","1","false","0","18605","0"
"5.8450805869617515","0.0","0.17108403983866985","1.0","11","6","3","false","21158","7.333333333333333","3","3","false","0","21158","0"
"4.903536203993264","0.0","0.20393445839874413","1.0","11","24","12","false","4632","50.0","12","12","false","0","4632","0"
"4.9862881885975465","4.227881085297898","0.2005499807024315","0.358974358974359","10","26","13","false","7844","17.53846153846154","13","13","false","0","7844","719597039"
"5.095020447438056","0.0","0.19627006610009443","1.0","11","12","6","false","11053","37.0","6","6","false","0","11053","0"
"4.996391628578301","0.2324043111551129","0.20014443909484836","0.6888888888888889","10","20","10","false","11148","23.5","10","10","false","0","11148","48602454"
"4.8460428193408704","0.5873995917703864","0.20635393397865476","0.6428571428571429","10","16","8","false","13411","32.5","8","8","false","0","13411","133435759"
"4.895838344960308","3.2773855988584573","0.2042551100628931","0.7362637362637363","11","28","14","false","14512","43.214285714285715","14","14","false","0","14512","588543184"
"4.861919653596344","0.48498608716289693","0.20568007520657067","0.631578947368421","10","38","19","false","16594","37.31578947368421","19","19","false","0","16594","146248878"
"5.073610777002646","0.0","0.1970982883694467","1.0","10","14","7","false","16722","27.142857142857142","7","7","false","0","16722","0"
"5.294683666105365","0.0","0.18886869604725123","1.0","10","6","3","false","16726","26.333333333333332","3","3","false","0","16726","0"
"5.073610777002646","0.0","0.1970982883694467","1.0","10","14","7","false","16876","27.142857142857142","7","7","false","0","16876","0"
"4.843156122203512","0.2076948861230847","0.20647692842596732","0.7333333333333333","11","12","6","false","19954","30.5","6","6","false","0","19954","33258027"
"4.929757036324272","6.978088199720284","0.20284975357439128","0.26666666666666666","11","30","15","false","19992","15.333333333333334","15","15","false","0","19992","867202353"
"4.99975944190522","8.798952675961331","0.20000962278675904","0.3333333333333333","11","14","7","false","20391","15.428571428571429","7","7","false","0","20391","1525262958"
"4.89102718306471","0.07903681564626566","0.20445602990360023","0.7523809523809524","11","30","15","false","20774","41.46666666666667","15","15","false","0","20774","29348970"
"4.980755352417609","2.1430193888310294","0.20077276020284954","0.43636363636363634","10","22","11","false","23403","27.545454545454547","11","11","false","0","23403","640159402"
"5.980755352417609","0.0","0.16720296034108276","1.0","12","6","3","false","4870","6.666666666666667","3","3","false","0","4870","0"
"5.496271349530912","2.030459064787757","0.18194152661064425","0.3333333333333333","12","12","6","false","5175","10.833333333333334","6","6","false","0","5175","191084730"
"5.980755352417609","0.0","0.16720296034108276","1.0","12","6","3","false","8282","6.666666666666667","3","3","false","0","8282","0"
"5.143132066394034","12.420619485855138","0.19443405051449955","0.16363636363636364","11","22","11","false","22046","7.636363636363637","11","11","false","0","22046","863337956"
"5.307914361318258","2.7786607445720644","0.18839791525039656","0.8324420677361853","11","68","34","false","2449","37.55882352941177","34","34","false","0","2449","526428849"
"5.7211931681501085","0.0","0.1747887146280957","1.0","12","4","2","false","4766","9.0","2","2","false","0","4766","0"
"5.084435891267741","6.87521680423932","0.1966786525359576","0.2222222222222222","11","18","9","false","3561","8.222222222222221","9","9","false","0","3561","476796344"
"5.919894154438297","2.819390105703497","0.1689219391279613","0.06666666666666667","12","12","6","false","4868","4.333333333333333","6","6","false","0","4868","192302702"
"5.858792398364205","0.156248672991111","0.17068363785670293","0.0","12","4","2","false","8352","6.5","2","2","false","0","8352","9240669"
"5.030310319942266","11.535232081073431","0.19879489264023723","0.027777777777777776","11","18","9","false","10456","6.666666666666667","9","9","false","0","10456","919373526"
"5.381525138320905","0.7612532104318399","0.18582092888114074","0.6","11","10","5","false","15365","10.8","5","5","false","0","15365","49006266"
"5.379119557373105","10.324342059719067","0.18590402933679176","0.32142857142857145","11","16","8","false","16931","7.875","8","8","false","0","16931","665634114"
"1.0","0.0","1.0","0.0","1","2","1","false","8157","1.0","1","1","false","0","8157","0"
"1.0","0.0","1.0","0.0","1","2","1","false","2120","1.0","1","1","false","0","2120","0"
"1.0","0.0","1.0","0.0","1","2","1","false","7713","1.0","1","1","false","0","7713","0"
"1.0","0.0","1.0","0.0","1","2","1","false","19052","1.0","1","1","false","0","19052","0"
"1.0","0.0","1.0","0.0","1","2","1","false","8302","1.0","1","1","false","0","8302","0"
"1.0","0.0","1.0","0.0","1","2","1","false","16484","1.0","1","1","false","0","16484","0"
"5.161895597786866","1.2280183385876182","0.19372728120048466","0.4","10","10","5","false","17778","9.0","5","5","false","0","17778","85896766"
"4.680538850132307","23.551844657514653","0.2136506141748471","0.09090909090909091","10","22","11","false","2556","11.090909090909092","11","11","false","0","2556","1757048593"
"5.4729372143372625","1.1828814216209111","0.18271724319810118","0.3333333333333333","11","12","6","false","19159","7.833333333333333","6","6","false","0","19159","96405441"
"5.450805869617513","0.004478519120212976","0.18345911116995453","0.6666666666666666","10","6","3","false","21699","9.333333333333334","3","3","false","0","21699","317700"
"5.23935530430599","0.07648875564139944","0.1908631772268136","0.6666666666666666","10","6","3","false","25382","12.333333333333334","3","3","false","0","25382","8263158"
"5.236468607168631","11.213740013634993","0.1909683939728041","0.06666666666666667","11","20","10","false","8701","8.4","10","10","false","0","8701","1030399141"
"6.235746932884291","1.1842948209624962","0.16036571252218193","0.0","12","4","2","false","523","5.5","2","2","false","0","523","104664342"
"5.410392109694492","4.094480337964831","0.18482948735049573","0.26666666666666666","10","12","6","false","5464","6.666666666666667","6","6","false","0","5464","380484898"
"6.003367813326919","0.15261771895286227","0.1665731687770476","0.6666666666666666","11","8","4","false","7774","5.5","4","4","false","0","7774","19491264"
"5.165744527303343","12.923036643379579","0.193582937505821","0.10989010989010989","10","28","14","false","17379","7.714285714285714","14","14","false","0","17379","951556652"
"6.003367813326919","1.4851612237021266","0.1665731687770476","0.5","11","8","4","false","18008","5.25","4","4","false","0","18008","128263078"
"6.236228049073851","0.0","0.16035334053386824","0.0","12","2","1","false","23385","10.0","1","1","false","0","23385","0"
"6.236228049073851","0.0","0.16035334053386824","0.0","12","2","1","false","25868","10.0","1","1","false","0","25868","0"
"5.525619437094059","0.4985308797398834","0.18097518502394427","0.0","10","4","2","false","26170","16.0","2","2","false","0","26170","37088132"
"5.301419292759201","5.209919555436291","0.1886287321898539","0.2545454545454545","10","22","11","false","1310","8.0","11","11","false","0","1310","532674003"
"5.370459465961029","1.7152225016579328","0.1862038073908175","0.3333333333333333","10","6","3","false","2922","14.666666666666666","3","3","false","0","2922","128071619"
"4.8715419773875395","15.75061213982685","0.20527381363883263","0.3378151260504202","10","70","35","false","3651","14.742857142857142","35","35","false","0","3651","1235660256"
"5.36901611739235","0.7917739042067024","0.18625386442044894","0.47619047619047616","10","14","7","false","6891","11.571428571428571","7","7","false","0","6891","72205818"
"5.737551118595141","0.0","0.17429038614733136","1.0","10","4","2","false","10162","24.5","2","2","false","0","10162","0"
"5.798412316574453","0.6132430770349053","0.17246100232326583","0.3333333333333333","11","6","3","false","10620","7.0","3","3","false","0","10620","38703262"
"5.781813808034641","1.1506264697717568","0.1729561056792178","0.5","11","8","4","false","11112","7.25","4","4","false","0","11112","76522062"
"5.7385133509742605","0.2355278993100322","0.1742611611821421","0.5","11","8","4","false","13174","7.75","4","4","false","0","13174","16635127"
"5.045946596102959","6.938934200914789","0.1981788710907704","0.24444444444444444","11","20","10","false","14864","9.2","10","10","false","0","14864","476687609"
"4.864806350733702","13.327701732652628","0.20555802798793452","0.1111111111111111","10","20","10","false","17536","12.5","10","10","false","0","17536","1020099957"
"5.737551118595141","0.0","0.17429038614733136","1.0","10","4","2","false","23153","24.5","2","2","false","0","23153","0"
"6.098388260764975","3.8968089198502716","0.163977752356909","0.3333333333333333","11","6","3","false","24340","7.333333333333333","3","3","false","0","24340","283010825"
"5.262208323310079","6.928752507258239","0.1900342857142857","0.2","11","10","5","false","11102","15.6","5","5","false","0","11102","568418986"
"5.939619918210248","3.499741498447717","0.1683609412336479","0.2","11","10","5","false","18592","3.4","5","5","false","0","18592","284857890"
"5.940341592494588","0.0","0.16834048756783024","1.0","11","4","2","false","22765","7.5","2","2","false","0","22765","0"
"5.498195814289151","5.249142082285627","0.1818778438921946","0.07142857142857142","11","16","8","false","1896","3.0","8","8","false","0","1896","377357665"
"5.858551840269425","5.358755256441292","0.1706906463004024","0.3333333333333333","11","14","7","false","6838","4.571428571428571","7","7","false","0","6838","486417875"
"6.0050517199903775","0.0","0.16652645915955616","1.0","11","4","2","false","25220","6.5","2","2","false","0","25220","0"
"5.191243685350012","7.783390454301384","0.19263206672845226","0.3333333333333333","11","12","6","false","4180","30.833333333333332","6","6","false","0","4180","2019047094"
"4.834255472696657","18.562784750487086","0.20685708598726113","0.1323529411764706","10","34","17","false","10055","10.764705882352942","17","17","false","0","10055","1896845203"
"5.199903776762088","9.28094243969679","0.19231125092524054","0.3333333333333333","10","6","3","false","12637","23.333333333333332","3","3","false","0","12637","817777143"
"5.452249218186192","0.0","0.18341054489300684","1.0","11","6","3","false","1832","19.0","3","3","false","0","1832","0"
"5.523213856146259","0.0","0.18105400696864113","0.0","11","2","1","false","4383","31.0","1","1","false","0","4383","0"
"5.312244407024297","0.0","0.18824435085812616","1.0","11","4","2","false","7014","26.0","2","2","false","0","7014","0"
"5.091893192205918","2.7806975835171137","0.19639060802192093","0.7628458498023716","10","46","23","false","9397","20.73913043478261","23","23","false","0","9397","279225789"
"5.15347606446957","0.6195425016356841","0.19404378471735984","0.3333333333333333","11","6","3","false","14344","17.333333333333332","3","3","false","0","14344","71715806"
"5.452249218186192","0.0","0.18341054489300684","1.0","11","6","3","false","14385","19.0","3","3","false","0","14385","0"
"4.582631705556892","18.31147020689303","0.21821522309711286","0.19913419913419914","10","44","22","false","21379","22.181818181818183","22","22","false","0","21379","3975976669"
"5.451286985807072","0.0","0.18344291955341777","1.0","11","4","2","false","24163","17.0","2","2","false","0","24163","0"
"4.626653836901612","16.680864130290114","0.2161389278843654","0.14035087719298245","10","38","19","false","4416","9.210526315789474","19","19","false","0","4416","1768679703"
"4.832571566033197","18.515394169864273","0.20692916521479418","0.10256410256410256","10","26","13","false","9241","8.538461538461538","13","13","false","0","9241","1648995963"
"5.194130382487371","8.408038987697221","0.19252500926268987","0.5","11","16","8","false","2620","12.875","8","8","false","0","2620","1102070541"
"5.320904498436373","0.5152486368666817","0.18793797187937972","0.6666666666666666","12","6","3","false","3679","15.333333333333334","3","3","false","0","3679","56080397"
"5.23959586240077","16.413182251920315","0.1908544143978697","0.5037878787878788","12","66","33","false","4364","18.96969696969697","33","33","false","0","4364","1458285413"
"4.977146980995911","7.977027410479737","0.20091831802803287","0.13186813186813187","11","28","14","false","5712","11.142857142857142","14","14","false","0","5712","957438567"
"5.011546788549435","4.001328275902176","0.19953919262708203","0.2727272727272727","11","24","12","false","13955","9.75","12","12","false","0","13955","384167274"
"5.031994226605725","3.434044274542617","0.19872836791280238","0.26666666666666666","11","12","6","false","14003","12.833333333333334","6","6","false","0","14003","434073000"
"4.840991099350493","7.035983861100712","0.2065692705227589","0.2857142857142857","11","16","8","false","15235","13.875","8","8","false","0","15235","626777847"
"5.2076016357950445","2.46236488450128","0.1920269770879527","0.3333333333333333","11","8","4","false","18227","14.75","4","4","false","0","18227","240015330"
"5.621121000721674","0.0","0.1779004579107288","0.0","12","2","1","false","19445","18.0","1","1","false","0","19445","0"
"5.621121000721674","0.0","0.1779004579107288","0.0","12","2","1","false","19495","18.0","1","1","false","0","19495","0"
"4.778686552802502","12.574404822571381","0.2092625220236597","0.17777777777777778","10","20","10","false","20168","15.1","10","10","false","0","20168","1265033671"
"4.545826317055569","31.975611514581228","0.21998200772609408","0.2","11","30","15","false","23967","15.066666666666666","15","15","false","0","23967","3137294717"
"5.954534520086601","8.673856144122452","0.1679392396881186","0.3611111111111111","12","18","9","false","1116","6.222222222222222","9","9","false","0","1116","793919647"
"5.905460668751504","0.858183999390617","0.16933479978817875","0.3333333333333333","12","6","3","false","15399","6.333333333333333","3","3","false","0","15399","80075753"
"5.998316093336541","3.0494912393094613","0.16671345498295567","0.5","12","8","4","false","18222","4.75","4","4","false","0","18222","272956355"
"5.467163820062545","2.2713883244579414","0.18291019492233906","0.35714285714285715","12","16","8","false","21287","7.5","8","8","false","0","21287","266486161"
"5.99975944190522","0.0","0.16667334910388518","0.0","12","2","1","false","23227","10.0","1","1","false","0","23227","0"
"4.929035362039933","19.35656666544459","0.20287945339189847","0.045454545454545456","11","24","12","false","4624","7.916666666666667","12","12","false","0","4624","1462243467"
"5.928554245850373","0.0","0.16867518766484074","1.0","12","4","2","false","5355","7.0","2","2","false","0","5355","0"
"5.928554245850373","0.0","0.16867518766484074","1.0","12","4","2","false","6863","7.0","2","2","false","0","6863","0"
"5.437575174404619","3.0883615848873562","0.18390550345071668","0.2857142857142857","11","14","7","false","12606","7.857142857142857","7","7","false","0","12606","285002246"
"4.990858792398364","5.9657917222632335","0.20036631802188268","0.2","11","20","10","false","12968","14.7","10","10","false","0","12968","606303874"
"5.926629781092133","4.488023726112917","0.16872995900474896","0.2","12","10","5","false","15770","4.2","5","5","false","0","15770","373308738"
"5.928794803945153","0.0","0.1686683437474641","0.0","12","2","1","false","21322","12.0","1","1","false","0","21322","0"
"5.297089247053163","9.165649826403117","0.18878292461398727","0.12727272727272726","12","22","11","false","22265","7.181818181818182","11","11","false","0","22265","535070712"
"4.922059177291316","8.319608974011443","0.20316700063535506","0.16363636363636364","11","22","11","false","22336","9.454545454545455","11","11","false","0","22336","597101932"
"5.927592013471253","0.0","0.16870256888924962","1.0","12","4","2","false","23099","8.5","2","2","false","0","23099","0"
"5.033918691363964","5.245782194581726","0.19865239415081717","0.14285714285714285","10","14","7","false","23880","9.571428571428571","7","7","false","0","23880","484321403"
"5.365648304065432","1.7970580674358625","0.18637076888590004","0.6","11","10","5","false","25111","10.8","5","5","false","0","25111","167213073"
"6.925667548713014","0.49641359484321235","0.14439041333796457","0.6666666666666666","13","6","3","false","4319","3.3333333333333335","3","3","false","0","4319","67486361"
"6.925667548713014","0.49641359484321235","0.14439041333796457","0.6666666666666666","13","6","3","false","12758","3.3333333333333335","3","3","false","0","12758","67486361"
"6.926389222997354","0.0","0.14437536901330184","0.0","13","2","1","false","22023","5.0","1","1","false","0","22023","0"
"6.2874669232619675","6.198653098470692","0.15904656234456901","0.1388888888888889","12","18","9","false","14337","3.5555555555555554","9","9","false","0","14337","535198737"
"6.710849170074573","0.0","0.149012438613471","1.0","12","6","3","false","5849","8.0","3","3","false","0","5849","0"
"7.287226365167188","0.0","0.137226421945664","0.0","13","2","1","false","10763","9.0","1","1","false","0","10763","0"
"7.287226365167188","0.0","0.137226421945664","0.0","13","2","1","false","11121","9.0","1","1","false","0","11121","0"
"6.709646379600674","1.594225309102313","0.1490391510110426","0.3333333333333333","12","12","6","false","11194","4.833333333333333","6","6","false","0","11194","158935445"
"5.858551840269425","11.09550541657061","0.1706906463004024","0.19444444444444445","11","18","9","false","15799","6.555555555555555","9","9","false","0","15799","992400674"
"6.488092374308396","1.8610841317973492","0.15412850839790887","0.3333333333333333","13","8","4","false","16511","5.5","4","4","false","0","16511","177562140"
"5.558094779889343","11.084797159128346","0.1799177667171608","0.13333333333333333","12","12","6","false","16575","7.666666666666667","6","6","false","0","16575","915172658"
"7.287226365167188","0.0","0.137226421945664","0.0","13","2","1","false","16945","9.0","1","1","false","0","16945","0"
"7.287226365167188","0.0","0.137226421945664","0.0","13","2","1","false","21157","9.0","1","1","false","0","21157","0"
"6.036083714216983","1.452729578056475","0.16567033317392","0.5714285714285714","12","14","7","false","2326","11.285714285714286","7","7","false","0","2326","200787234"
"6.7659369737791675","0.0","0.14779918936215602","1.0","12","4","2","false","10253","8.0","2","2","false","0","10253","0"
"5.1279769064229015","21.44923925748056","0.19500867851949147","0.05454545454545454","10","22","11","false","13190","6.545454545454546","11","11","false","0","13190","1877832529"
"6.857108491700746","0.0","0.14583406419926329","1.0","12","4","2","false","14325","7.5","2","2","false","0","14325","0"
"5.831849891748857","8.575238523266739","0.17147217753578353","0.3484848484848485","12","24","12","false","19048","10.0","12","12","false","0","19048","1159188376"
"6.273273995669954","4.955900386716528","0.1594063961960273","0.14285714285714285","12","14","7","false","20182","5.428571428571429","7","7","false","0","20182","377448949"
"5.30454654799134","0.0","0.188517527549771","1.0","11","8","4","false","3595","48.5","4","4","false","0","3595","0"
"5.30454654799134","0.0","0.188517527549771","1.0","11","8","4","false","18174","48.5","4","4","false","0","18174","0"
"5.550637478951167","0.0","0.18015948686833666","0.0","11","2","1","false","17850","16.0","1","1","false","0","17850","0"
"5.550637478951167","0.0","0.18015948686833666","0.0","11","2","1","false","20620","16.0","1","1","false","0","20620","0"
"5.517440461871542","2.584442489829532","0.1812434600627834","0.0","11","6","3","false","12380","8.333333333333334","3","3","false","0","12380","200541798"
"5.303584315612221","0.0","0.18855173039415793","1.0","11","6","3","false","3197","17.0","3","3","false","0","3197","0"
"5.335819100312725","0.0","0.1874126504666156","1.0","11","6","3","false","6160","15.333333333333334","3","3","false","0","6160","0"
"5.118595140726486","0.19470794944786982","0.19536610583701475","0.6190476190476191","11","14","7","false","8589","12.714285714285714","7","7","false","0","8589","36863565"
"5.354823189800337","0.14238745740566733","0.1867475292003594","0.0","11","4","2","false","9417","17.5","2","2","false","0","9417","15980649"
"4.828722636516718","13.522634225994969","0.207094106511234","0.11428571428571428","10","30","15","false","9829","8.066666666666666","15","15","false","0","9829","1140430335"
"4.8696175126293","5.467836565360046","0.20535493750926248","0.1","10","10","5","false","14638","16.0","5","5","false","0","14638","391771768"
"4.681260524416647","40.06121400069359","0.21361767728674202","0.1067193675889328","11","46","23","false","14924","8.173913043478262","23","23","false","0","14924","3894383732"
"5.503969208563868","0.0","0.18168706293706294","0.0","11","2","1","false","15972","20.0","1","1","false","0","15972","0"
"5.058696175126293","12.56596579652562","0.19767939512102334","0.13636363636363635","10","24","12","false","17228","7.916666666666667","12","12","false","0","17228","963689828"
"4.7834977146980995","19.705141137400183","0.20905204928337945","0.13333333333333333","10","30","15","false","18940","11.466666666666667","15","15","false","0","18940","2269266738"
"5.335819100312725","0.0","0.1874126504666156","1.0","11","6","3","false","19090","16.666666666666668","3","3","false","0","19090","0"
"5.335819100312725","0.0","0.1874126504666156","1.0","11","6","3","false","19475","15.333333333333334","3","3","false","0","19475","0"
"5.090930959826798","6.910783640257551","0.19642772763785854","0.37777777777777777","10","20","10","false","20207","10.8","10","10","false","0","20207","736829235"
"4.787587202309358","18.440828936966152","0.20887348005225603","0.12121212121212122","10","24","12","false","22644","13.083333333333334","12","12","false","0","22644","1828346382"
"5.058215058936733","4.571988790446118","0.19769819755552384","0.21428571428571427","11","16","8","false","22790","11.125","8","8","false","0","22790","420581576"
"4.823189800336781","1.5054410142048507","0.20733167082294265","0.7333333333333333","11","12","6","false","24001","18.833333333333332","6","6","false","0","24001","351644021"
"5.1190762569160455","0.0","0.19534774436090224","1.0","11","10","5","false","25228","17.2","5","5","false","0","25228","0"
"5.200144334856868","17.217115927810365","0.19230235462830178","0.09473684210526316","11","40","20","false","9710","6.2","20","20","false","0","9710","1362598361"
"5.460909309598268","7.559595495100363","0.1831196863574292","0.12380952380952381","11","30","15","false","3345","5.0","15","15","false","0","3345","569600479"
"5.329324031753669","4.186716329631175","0.187641058048208","0.4","11","10","5","false","3430","11.2","5","5","false","0","3430","318471101"
"5.7476545585758965","2.5213147276886065","0.1739840120537396","0.3333333333333333","11","12","6","false","5266","7.833333333333333","6","6","false","0","5266","154489242"
"6.159490016839067","0.0","0.1623511033001367","1.0","12","6","3","false","5995","9.666666666666666","3","3","false","0","5995","0"
"6.460668751503488","0.0","0.1547827382060543","0.0","12","2","1","false","7999","15.0","1","1","false","0","7999","0"
"5.627134953091171","1.5024193396356798","0.17771032831737346","0.0","10","4","2","false","8047","13.5","2","2","false","0","8047","96415513"
"6.307192687033918","0.0","0.15854914375071513","1.0","12","4","2","false","8178","10.5","2","2","false","0","8178","0"
"6.460668751503488","0.0","0.1547827382060543","0.0","12","2","1","false","8868","15.0","1","1","false","0","8868","0"
"5.989896560019245","0.0","0.16694779116465863","1.0","12","4","2","false","10824","14.0","2","2","false","0","10824","0"
"5.097907144575415","16.49800565274677","0.19615892789731976","0.07692307692307693","11","26","13","false","15144","7.3076923076923075","13","13","false","0","15144","1442591246"
"5.519846042819341","1.5452232896827238","0.18116447311078182","0.3333333333333333","12","12","6","false","19107","11.666666666666666","6","6","false","0","19107","144567599"
"6.288429155641087","0.0","0.15902222562258522","1.0","12","4","2","false","19806","11.5","2","2","false","0","19806","0"
"5.997834977146981","0.0","0.1667268278987687","1.0","12","6","3","false","22439","13.666666666666666","3","3","false","0","22439","0"
"6.460668751503488","0.0","0.1547827382060543","0.0","12","2","1","false","23304","15.0","1","1","false","0","23304","0"
"5.4907385133509745","4.280715984682092","0.1821248630887185","0.2857142857142857","12","16","8","false","24431","7.375","8","8","false","0","24431","282505001"
"5.821265335578542","14.225339950656702","0.171783958014794","0.15384615384615385","11","28","14","false","11077","5.714285714285714","14","14","false","0","11077","1545881445"
"5.618955977868655","6.884228110512428","0.1779690041955647","0.37777777777777777","11","20","10","false","10211","10.7","10","10","false","0","10211","1097272448"
"6.820543661294202","0.0","0.1466158783902938","1.0","12","6","3","false","14972","6.666666666666667","3","3","false","0","14972","0"
"5.593216261727207","17.250685633893518","0.17878800911788742","0.2222222222222222","11","38","19","false","15300","7.578947368421052","19","19","false","0","15300","2145313081"
"6.820543661294202","0.0","0.1466158783902938","1.0","12","6","3","false","17158","7.666666666666667","3","3","false","0","17158","0"
"6.820784219388982","0.0","0.14661070748395288","1.0","12","4","2","false","17162","9.5","2","2","false","0","17162","0"
"6.820303103199422","3.0642794845157223E-4","0.14662104966139955","0.6666666666666666","12","8","4","false","17403","6.25","4","4","false","0","17403","10588"
"6.820784219388982","0.0","0.14661070748395288","1.0","12","4","2","false","20149","9.0","2","2","false","0","20149","0"
"6.820543661294202","0.0","0.1466158783902938","1.0","12","6","3","false","20519","6.666666666666667","3","3","false","0","20519","0"
"6.820062545104642","5.628939794799402E-4","0.14662622129730873","0.6","12","10","5","false","21389","5.4","5","5","false","0","21389","21219"
"5.6143853740678376","5.354730257117385","0.1781138866275333","0.25","12","16","8","false","22951","6.375","8","8","false","0","22951","620215534"
"6.820543661294202","0.0","0.1466158783902938","1.0","12","6","3","false","23912","6.666666666666667","3","3","false","0","23912","0"
"6.820303103199422","1.024127660484197E-4","0.14662104966139955","0.8333333333333334","12","8","4","false","23918","6.5","4","4","false","0","23918","5308"
"6.052201106567236","0.0","0.16522914265272864","1.0","12","6","3","false","25589","11.0","3","3","false","0","25589","0"
"5.990618234303584","0.0","0.1669276793960567","0.0","12","2","1","false","6895","10.0","1","1","false","0","6895","0"
"5.256194370940582","0.1548426997813848","0.1902517162471396","0.6666666666666666","11","8","4","false","3076","24.25","4","4","false","0","3076","40677170"
"5.135915323550638","2.866971684194266","0.1947072599531616","0.8121693121693122","11","56","28","false","7444","39.285714285714285","28","28","false","0","7444","628956044"
"4.78277604041376","0.8311490605890478","0.2090835931998793","0.5","11","8","4","false","8972","24.0","4","4","false","0","8972","91998770"
"5.4784700505172","0.0","0.18253271274260122","1.0","12","4","2","false","17308","15.5","2","2","false","0","17308","0"
"5.133750300697619","4.3619915842239285","0.19478937256923293","0.8393393393393394","11","74","37","false","20574","38.16216216216216","37","37","false","0","20574","787642535"
"5.241760885253789","0.8074671388465348","0.19077558513079396","0.5238095238095238","11","14","7","false","21629","23.571428571428573","7","7","false","0","21629","101631980"
"5.949001683906664","0.0","0.16809543065103114","1.0","12","4","2","false","245","12.0","2","2","false","0","245","0"
"5.6769304787106085","0.0","0.1761515318445697","1.0","12","4","2","false","4983","12.5","2","2","false","0","4983","0"
"5.723839307192687","3.7704845992633964","0.1747079095570312","0.26666666666666666","12","12","6","false","13480","7.0","6","6","false","0","13480","342877816"
"6.097666586480635","0.0","0.16399715953921415","0.0","12","2","1","false","14562","13.0","1","1","false","0","14562","0"
"6.046427712292519","0.0","0.16538691068231548","1.0","12","4","2","false","15912","9.5","2","2","false","0","15912","0"
"5.531633389463556","5.285400589091423","0.18077843009349856","0.4","12","22","11","false","16976","9.090909090909092","11","11","false","0","16976","458115620"
"5.408467644936252","3.5931535116740876","0.18489525419205624","0.16666666666666666","12","8","4","false","19974","7.5","4","4","false","0","19974","243965548"
"6.097666586480635","0.0","0.16399715953921415","0.0","12","2","1","false","22245","13.0","1","1","false","0","22245","0"
"6.408227086841472","0.0","0.15604940125380082","0.0","13","2","1","false","414","4.0","1","1","false","0","414","0"
"1.0","0.0","1.0","0.0","1","2","1","false","8708","1.0","1","1","false","0","8708","0"
"1.0","0.0","1.0","0.0","1","2","1","false","23776","1.0","1","1","false","0","23776","0"
"5.481597305749339","2.870836650946803","0.18242857769781015","0.17857142857142858","11","16","8","false","1044","6.125","8","8","false","0","1044","529263499"
"5.3856146259321624","1.8280715080929575","0.18567982847954262","0.1","11","10","5","false","4975","9.8","5","5","false","0","4975","174941930"
"5.713014192927592","0.0","0.1750389490083793","1.0","11","4","2","false","5809","12.5","2","2","false","0","5809","0"
"4.951647822949242","18.193609825033807","0.2019529731830548","0.0761904761904762","10","30","15","false","12587","7.133333333333334","15","15","false","0","12587","1674435951"
"5.075775799855665","2.8022398526316232","0.19701421800947866","0.3","10","10","5","false","16123","11.6","5","5","false","0","16123","318284796"
"5.317777243204234","6.480104944928276","0.18804849362164117","0.2222222222222222","11","20","10","false","20303","7.2","10","10","false","0","20303","774234415"
"6.249699302381525","0.0","0.16000769822940725","1.0","12","4","2","false","4451","15.0","2","2","false","0","4451","0"
"6.317536685109454","0.0","0.1582895438275836","0.0","12","2","1","false","9983","10.0","1","1","false","0","9983","0"
"6.249218186191966","9.992383484641383E-5","0.16002001693740855","0.8333333333333334","12","8","4","false","15205","9.0","4","4","false","0","15205","5179"
"6.249458744286745","0.0","0.16001385734631818","1.0","12","6","3","false","15666","11.333333333333334","3","3","false","0","15666","0"
"6.249458744286745","0.0","0.16001385734631818","1.0","12","6","3","false","15667","11.333333333333334","3","3","false","0","15667","0"
"5.285542458503729","4.349334102900329","0.1891953395230293","0.4","11","10","5","false","19093","16.6","5","5","false","0","19093","332715572"
"6.249699302381525","0.0","0.16000769822940725","1.0","12","4","2","false","21031","15.0","2","2","false","0","21031","0"
"5.549915804666827","10.065587527948018","0.1801829136144944","0.1631578947368421","11","40","20","false","24330","5.6","20","20","false","0","24330","1035265420"
"5.682222756795766","0.0","0.17598746877778249","1.0","12","4","2","false","5840","9.5","2","2","false","0","5840","0"
"5.23959586240077","0.7438608010008595","0.1908544143978697","0.3333333333333333","11","14","7","false","6732","8.571428571428571","7","7","false","0","6732","73030421"
"5.78253548231898","0.0","0.17293452034279058","0.0","12","2","1","false","8614","12.0","1","1","false","0","8614","0"
"4.923983642049555","3.7001054545003984","0.2030875958766916","0.2857142857142857","11","14","7","false","13847","14.0","7","7","false","0","13847","501240844"
"5.665624248255954","0.41564503687403626","0.1765030570652174","0.3333333333333333","12","8","4","false","15081","7.5","4","4","false","0","15081","39868007"
"5.6507096463796005","0.016734622583549106","0.17696892294593444","0.6666666666666666","12","6","3","false","22609","10.333333333333334","3","3","false","0","22609","3643426"
"4.599230214096704","16.01216611299426","0.2174276897327266","0.11666666666666667","11","32","16","false","3310","11.125","16","16","false","0","3310","1734732634"
"5.390185229732981","0.0","0.18552238139867006","1.0","12","4","2","false","5143","14.0","2","2","false","0","5143","0"
"5.035121481837864","1.59909946598891","0.19860494004108736","0.3333333333333333","10","8","4","false","9735","15.75","4","4","false","0","9735","134382221"
"5.78253548231898","0.0","0.17293452034279058","0.0","12","2","1","false","17396","12.0","1","1","false","0","17396","0"
"5.54366129420255","0.0","0.1803862009112606","1.0","11","4","2","false","26138","8.0","2","2","false","0","26138","0"
"5.84652393553043","0.0","0.17104180381830153","1.0","10","4","2","false","4700","13.0","2","2","false","0","4700","0"
"5.84652393553043","0.0","0.17104180381830153","1.0","10","4","2","false","5606","13.0","2","2","false","0","5606","0"
"5.467644936252105","1.1619612360157185","0.18289410004839632","0.3333333333333333","10","6","3","false","1386","14.0","3","3","false","0","1386","85385144"
"5.845802261246091","1.2689346888245598","0.17106291922143121","0.3333333333333333","10","6","3","false","1738","9.333333333333334","3","3","false","0","1738","89227358"
"5.8460428193408704","1.487105252617256","0.17105588017447124","0.3333333333333333","10","6","3","false","2566","9.0","3","3","false","0","2566","103791481"
"5.76184748616791","0.7817182446529075","0.17355544422177688","0.3333333333333333","10","6","3","false","2720","9.333333333333334","3","3","false","0","2720","54065569"
"5.67308154919413","0.19578766611236678","0.17627104270025018","0.0","10","4","2","false","5634","14.0","2","2","false","0","5634","17706831"
"5.7830165985085396","0.0","0.17292013311148088","1.0","10","6","3","false","9870","12.666666666666666","3","3","false","0","9870","0"
"5.84628337743565","0.0","0.1710488417067852","1.0","10","4","2","false","16779","13.5","2","2","false","0","16779","0"
"5.7830165985085396","0.0","0.17292013311148088","1.0","10","6","3","false","24475","12.666666666666666","3","3","false","0","24475","0"
"5.7298532595621845","5.003022686227579","0.1745245392333851","0.28888888888888886","10","20","10","false","25931","6.9","10","10","false","0","25931","601699438"
"7.19581428915083","3.8066392760752588","0.13896967873499816","0.2","14","10","5","false","1817","2.6","5","5","false","0","1817","302038232"
"6.558335337984123","0.4847741249129623","0.15247771705241536","0.6666666666666666","13","8","4","false","3725","5.5","4","4","false","0","3725","46865952"
"7.19653596343517","0.0","0.13895574274635647","1.0","14","4","2","false","5366","5.5","2","2","false","0","5366","0"
"6.558335337984123","0.4847741249129623","0.15247771705241536","0.6666666666666666","13","8","4","false","15911","5.5","4","4","false","0","15911","46865952"
"5.215540052922781","1.7539801979104597","0.19173469858401365","0.3333333333333333","11","18","9","false","9800","18.333333333333332","9","9","false","0","9800","292741101"
"5.379360115467885","0.0","0.1858957159466953","1.0","11","8","4","false","26141","34.25","4","4","false","0","26141","0"
"5.620880442626895","0.0","0.1779080715569631","1.0","10","4","2","false","18001","14.0","2","2","false","0","18001","0"
"4.653115227327399","25.26474529162919","0.21490978648606732","0.1380952380952381","10","42","21","false","22177","9.047619047619047","21","21","false","0","22177","2594642687"
"5.4823189800336785","1.337793933320293","0.1824045634050022","0.38095238095238093","10","14","7","false","25480","8.142857142857142","7","7","false","0","25480","161222246"
"5.288188597546307","2.4610158627611316","0.18910066869853978","0.3055555555555556","11","18","9","false","1425","9.222222222222221","9","9","false","0","1425","271101216"
"4.849891748857349","7.137493589185776","0.2061901691384356","0.2","10","20","10","false","2501","11.1","10","10","false","0","2501","661043951"
"5.432042338224681","0.0","0.18409282139852087","1.0","11","8","4","false","2823","10.5","4","4","false","0","2823","0"
"5.3406302622083235","0.0","0.18724381784604296","1.0","10","4","2","false","5136","20.5","2","2","false","0","5136","0"
"5.374308395477508","0.0","0.18607045342643572","1.0","11","10","5","false","7105","14.2","5","5","false","0","7105","0"
"5.23959586240077","0.9393024598640205","0.1908544143978697","0.5238095238095238","10","14","7","false","7317","8.857142857142858","7","7","false","0","7317","72778903"
"5.432042338224681","0.0","0.18409282139852087","1.0","11","8","4","false","9127","10.5","4","4","false","0","9127","0"
"4.835698821265336","14.421020281537336","0.20679534374689085","0.26666666666666666","11","20","10","false","14615","11.3","10","10","false","0","14615","1251187775"
"5.286504690882849","2.115535629997022","0.18916090280305786","0.6","11","12","6","false","17089","11.333333333333334","6","6","false","0","17089","288597434"
"5.3762328602357465","0.0","0.1860038480468925","1.0","11","6","3","false","19454","12.333333333333334","3","3","false","0","19454","0"
"4.898003367813327","4.836048163584491","0.2041648249103679","0.2545454545454545","9","22","11","false","22758","10.181818181818182","11","11","false","0","22758","585800353"
"5.217945633870579","13.69048008485114","0.19164630491909088","0.28888888888888886","11","20","10","false","23841","10.5","10","10","false","0","23841","1319547015"
"6.4820784219388985","0.0","0.1542715059749128","0.0","11","2","1","false","3207","7.0","1","1","false","0","3207","0"
"5.320423382246813","2.7443924467256564","0.18795496676764478","0.28888888888888886","10","20","10","false","7125","6.9","10","10","false","0","7125","262660955"
"5.125811883569882","1.960604954692348","0.19509104561666982","0.38095238095238093","10","14","7","false","20683","10.0","7","7","false","0","20683","210963937"
"5.333654077459706","0.3993858693554453","0.18748872451740936","0.7","10","10","5","false","25419","9.8","5","5","false","0","25419","56169157"
"4.84724560981477","4.138307123884064","0.20630272952853598","0.06666666666666667","11","12","6","false","2591","16.166666666666668","6","6","false","0","2591","396931885"
"5.7659369737791675","0.0","0.1734323501189036","0.0","12","2","1","false","8932","11.0","1","1","false","0","8932","0"
"5.449603079143613","0.06630242840585505","0.1834996027191666","0.6666666666666666","11","6","3","false","9188","8.333333333333334","3","3","false","0","9188","9239268"
"5.495549675246572","0.0","0.18196541912891223","1.0","11","4","2","false","9773","10.5","2","2","false","0","9773","0"
"5.502525859995189","0.0","0.1817347206435254","1.0","11","4","2","false","13713","12.0","2","2","false","0","13713","0"
"5.031994226605725","2.4223222231727033","0.19872836791280238","0.23809523809523808","12","14","7","false","19179","11.857142857142858","7","7","false","0","19179","259461663"
"5.518643252345441","0.9608071741732598","0.18120395797916394","0.4","11","10","5","false","14818","9.8","5","5","false","0","14818","125378886"
"5.06519124368535","2.17053494562705","0.19742591185410335","0.4","11","10","5","false","26190","22.4","5","5","false","0","26190","310475767"
"5.210007216742843","6.157461402248832","0.19193831378705328","0.19047619047619047","11","30","15","false","3839","9.4","15","15","false","0","3839","735716258"
"5.5980274236228045","0.0","0.1786343517682953","1.0","11","6","3","false","13615","12.333333333333334","3","3","false","0","13615","0"
"5.099350493144095","6.148142055487847","0.19610340598169637","0.2692307692307692","11","26","13","false","16674","17.153846153846153","13","13","false","0","16674","936756809"
"5.792879480394515","0.21929551609813455","0.17262572152319255","0.5","12","8","4","false","7042","9.75","4","4","false","0","7042","25285416"
"6.233100793841713","0.0","0.1604337925977384","1.0","13","4","2","false","9269","10.5","2","2","false","0","9269","0"
"5.0038489295164785","4.144613705858257","0.19984616124224797","0.14285714285714285","11","16","8","false","11661","10.75","8","8","false","0","11661","443087702"
"5.297570363242723","6.310173547003447","0.18876577967487057","0.11764705882352941","12","34","17","false","21994","7.352941176470588","17","17","false","0","21994","767948084"
"5.313206639403416","0.7668194495069626","0.18821025942862318","0.38181818181818183","12","22","11","false","9943","13.727272727272727","11","11","false","0","9943","121710198"
"4.78277604041376","14.87359325854963","0.2090835931998793","0.1437908496732026","11","36","18","false","10096","12.722222222222221","18","18","false","0","10096","1590525843"
"5.437334616309839","0.5859369651482385","0.18391363978232977","0.38095238095238093","11","14","7","false","15614","11.0","7","7","false","0","15614","82344158"
"5.409910993504932","9.207734998832418","0.1848459246742852","0.2","11","22","11","false","16368","8.454545454545455","11","11","false","0","16368","1061035562"
"5.185470291075295","5.111356412480874","0.19284653924661346","0.3333333333333333","11","12","6","false","17285","12.5","6","6","false","0","17285","574206781"
"5.460187635313928","1.417885675564344","0.18314388932945636","0.26666666666666666","12","12","6","false","21407","9.5","6","6","false","0","21407","126130673"
"5.10969449121963","0.20618213615634043","0.19570641683536558","0.5","11","8","4","false","8715","19.0","4","4","false","0","8715","29082089"
"5.560981477026702","0.0","0.17982437167452525","1.0","12","4","2","false","21142","10.5","2","2","false","0","21142","0"
"5.585277844599471","0.0","0.17904212249117063","1.0","12","4","2","false","21167","13.0","2","2","false","0","21167","0"
"1.0","0.0","1.0","0.0","1","2","1","false","13621","1.0","1","1","false","0","13621","0"
"1.0","0.0","1.0","0.0","1","2","1","false","25388","1.0","1","1","false","0","25388","0"
"7.449843637238393","0.0","0.13423100519874714","0.0","13","2","1","false","284","6.0","1","1","false","0","284","0"
"6.450084195333173","5.437216015843957","0.15503673591168463","0.13333333333333333","12","12","6","false","6427","1.8333333333333333","6","6","false","0","6427","694895244"
"7.449603079143613","0.0","0.13423533970550244","1.0","13","4","2","false","16835","4.0","2","2","false","0","16835","0"
"7.449603079143613","0.0","0.13423533970550244","1.0","13","4","2","false","18677","4.0","2","2","false","0","18677","0"
"7.449603079143613","0.0","0.13423533970550244","1.0","13","4","2","false","21696","4.0","2","2","false","0","21696","0"
"7.449603079143613","0.0","0.13423533970550244","1.0","13","4","2","false","25854","4.0","2","2","false","0","25854","0"
"5.452730334375752","6.520967740441751","0.1833943618476199","0.0","11","4","2","false","25940","34.5","2","2","false","0","25940","833892171"
"6.031994226605725","0.0","0.16578265204386838","1.0","11","4","2","false","9485","6.5","2","2","false","0","9485","0"
"6.002165022853019","0.17805815780835152","0.16660654883571802","0.6666666666666666","11","6","3","false","10435","6.0","3","3","false","0","10435","41570661"
"6.481356747654559","0.0","0.15428868351705452","0.0","12","2","1","false","14698","8.0","1","1","false","0","14698","0"
"6.002165022853019","0.17805815780835152","0.16660654883571802","0.6666666666666666","11","6","3","false","21823","6.0","3","3","false","0","21823","41570661"
"5.549434688477267","9.5466407864185","0.18019853483029175","0.1111111111111111","12","18","9","false","811","5.333333333333333","9","9","false","0","811","869977261"
"6.168150108251143","0.2938701412205033","0.1621231621231621","0.6666666666666666","13","8","4","false","9964","6.5","4","4","false","0","9964","49576327"
"5.901611739235025","1.5328183995668347","0.169445237027677","0.3333333333333333","12","8","4","false","11919","5.5","4","4","false","0","11919","121801022"
"6.025980274236228","2.2112575863201855","0.16594810379241517","0.3333333333333333","12","6","3","false","15123","7.0","3","3","false","0","15123","142030998"
"6.548713014192928","1.4188111220726984","0.15270175954156412","0.0","13","4","2","false","17021","5.0","2","2","false","0","17021","100753756"
"5.738032234784701","10.52682959189198","0.1742757724395254","0.35714285714285715","11","16","8","false","19517","9.0","8","8","false","0","19517","1885384781"
"5.740678373827279","0.860912749514451","0.1741954408313778","0.7","11","10","5","false","22989","12.6","5","5","false","0","22989","103402756"
"6.1635795044503245","1.6548997314352945","0.1622433845913668","0.3333333333333333","13","12","6","false","23485","5.166666666666667","6","6","false","0","23485","178220067"
"7.025258599951888","1.128768097134534","0.14234351458704286","0.0","13","4","2","false","8069","2.0","2","2","false","0","8069","72478505"
"6.15179215780611","0.0","0.16255425644234153","0.0","13","2","1","false","2127","12.0","1","1","false","0","2127","0"
"5.15203271590089","10.22337874071971","0.1940981463323528","0.15151515151515152","12","24","12","false","11712","7.916666666666667","12","12","false","0","11712","927792716"
"5.372383930719269","8.105375354474043","0.18613710652397797","0.1978021978021978","11","28","14","false","10871","8.928571428571429","14","14","false","0","10871","1163401521"
"5.788308876593697","0.8665775022672518","0.1727620314188347","0.3333333333333333","12","8","4","false","15829","13.0","4","4","false","0","15829","79705348"
"5.861438537406784","0.062359891582399275","0.1706065829434458","0.8333333333333334","12","8","4","false","16106","6.5","4","4","false","0","16106","10537213"
"4.901611739235025","5.846014321321161","0.20401452689438557","0.28888888888888886","11","20","10","false","17207","11.8","10","10","false","0","17207","672460005"
"5.861438537406784","0.062359891582399275","0.1706065829434458","0.8333333333333334","12","8","4","false","17670","6.5","4","4","false","0","17670","10537213"
"5.227808515756555","2.31984011636294","0.19128474139517762","0.42857142857142855","11","14","7","false","18286","9.0","7","7","false","0","18286","215260645"
"5.769545345200866","0.1582368158078204","0.17332388258839226","0.6666666666666666","12","8","4","false","18612","9.5","4","4","false","0","18612","28756647"
"6.15179215780611","0.0","0.16255425644234153","0.0","13","2","1","false","19234","12.0","1","1","false","0","19234","0"
"6.15131104161655","0.0","0.1625669703961519","1.0","13","6","3","false","19724","6.666666666666667","3","3","false","0","19724","0"
"5.461149867693048","12.143491897902647","0.1831116201215752","0.08974358974358974","12","26","13","false","22876","8.692307692307692","13","13","false","0","22876","979223763"
"5.274236228049074","0.0","0.18960091220068415","1.0","12","6","3","false","3412","15.666666666666666","3","3","false","0","3412","0"
"5.286023574693289","0.05332802272957859","0.18917811959588604","0.7","12","10","5","false","894","11.8","5","5","false","0","894","6571111"
"5.171517921578061","3.9529939980447724","0.19336682482091358","0.3111111111111111","12","20","10","false","4814","8.4","10","10","false","0","4814","420777599"
"5.256194370940582","0.2336168352208169","0.1902517162471396","0.4642857142857143","12","16","8","false","5441","9.375","8","8","false","0","5441","26429131"
"4.963675727688237","5.83935659483518","0.20146360376078315","0.25","11","18","9","false","5717","10.555555555555555","9","9","false","0","5717","454283098"
"5.055568919894155","14.335375570250992","0.19780167491435097","0.25735294117647056","11","34","17","false","5934","10.294117647058824","17","17","false","0","5934","1790535328"
"5.3490497955256195","0.0","0.1869490915632308","1.0","12","4","2","false","9075","20.0","2","2","false","0","9075","0"
"5.162376713976426","1.1772911191071307","0.19370922646784713","0.4666666666666667","11","12","6","false","10623","13.0","6","6","false","0","10623","128716982"
"5.1539571806591296","0.8117245367946331","0.19402567094515752","0.3333333333333333","11","8","4","false","11223","12.5","4","4","false","0","11223","63467368"
"5.379119557373105","0.0","0.18590402933679176","1.0","12","6","3","false","11491","14.666666666666666","3","3","false","0","11491","0"
"5.3415924945874425","4.838105851991015","0.187210087818059","0.2777777777777778","12","18","9","false","12659","7.333333333333333","9","9","false","0","12659","439818303"
"4.997594419052201","6.863680356056136","0.2000962695547533","0.25","11","18","9","false","14351","10.0","9","9","false","0","14351","497489770"
"5.154678854943469","0.0","0.1939985066268434","1.0","11","4","2","false","19807","23.5","2","2","false","0","19807","0"
"5.344960307914361","1.4687950147959778","0.187092128358612","0.4","12","10","5","false","21324","9.4","5","5","false","0","21324","95327816"
"5.359634351695934","0.0","0.18657989228007182","1.0","12","8","4","false","21665","13.25","4","4","false","0","21665","0"
"5.395958624007698","0.0","0.18532388212741294","1.0","12","6","3","false","22734","14.333333333333334","3","3","false","0","22734","0"
"4.923983642049555","6.28777140532619","0.2030875958766916","0.24444444444444444","11","20","10","false","22778","13.0","10","10","false","0","22778","638371686"
"5.337021890786625","0.585537214149908","0.18737041377445235","0.4666666666666667","12","12","6","false","23246","10.166666666666666","6","6","false","0","23246","72754496"
"4.71734423863363","12.078180035836333","0.21198368179500254","0.14102564102564102","10","26","13","false","25698","15.076923076923077","13","13","false","0","25698","1541561205"
"4.867933605965841","7.018692340086472","0.20542597351255187","0.19047619047619047","11","14","7","false","7615","11.428571428571429","7","7","false","0","7615","634663526"
"4.9509261486649025","7.415436832369666","0.2019824109615665","0.26666666666666666","11","12","6","false","12806","14.5","6","6","false","0","12806","506938476"
"4.904257878277604","5.3520015489057835","0.20390444891352333","0.2857142857142857","11","14","7","false","1620","13.428571428571429","7","7","false","0","1620","442767267"
"4.979793120038489","12.609602060168147","0.20081155499734313","0.3333333333333333","11","20","10","false","3922","12.5","10","10","false","0","3922","1000474282"
"5.3225884050998316","0.0","0.18787851396547048","0.0","11","2","1","false","9133","32.0","1","1","false","0","9133","0"
"5.3225884050998316","0.0","0.18787851396547048","0.0","11","2","1","false","9895","32.0","1","1","false","0","9895","0"
"4.959586240076979","2.132887442492652","0.20162972304408983","0.3333333333333333","11","20","10","false","9907","13.1","10","10","false","0","9907","287730738"
"5.250180418571085","1.3437801493497639","0.1904696449026346","0.3333333333333333","11","6","3","false","11791","18.666666666666668","3","3","false","0","11791","101312490"
"5.3225884050998316","0.0","0.18787851396547048","0.0","11","2","1","false","18457","32.0","1","1","false","0","18457","0"
"5.3225884050998316","0.0","0.18787851396547048","0.0","11","2","1","false","19131","32.0","1","1","false","0","19131","0"
"5.3225884050998316","0.0","0.18787851396547048","0.0","11","2","1","false","19997","32.0","1","1","false","0","19997","0"
"4.590329564589848","15.176125210917826","0.21784928204590714","0.17894736842105263","11","40","20","false","21491","15.65","20","20","false","0","21491","2116164069"
"5.222756795766178","5.5549597599131735","0.19146976187186218","0.4666666666666667","11","12","6","false","22426","12.0","6","6","false","0","22426","474633252"
"5.23983642049555","0.0","0.19084565237351941","1.0","11","4","2","false","22791","19.5","2","2","false","0","22791","0"
"5.1024777483762325","4.102346943345058","0.19598321625571638","0.3333333333333333","10","6","3","false","25158","17.0","3","3","false","0","25158","332950643"
"4.970651912436853","4.448485196959218","0.20118085466776364","0.06666666666666667","10","12","6","false","25316","10.333333333333334","6","6","false","0","25316","322545982"
"5.771950926148665","0.0","0.17325164624489456","1.0","11","6","3","false","352","9.666666666666666","3","3","false","0","352","0"
"6.056531152273274","2.6345726898724577","0.16511101402073322","0.1","11","10","5","false","3996","3.6","5","5","false","0","3996","165353854"
"5.830887659369738","2.1972350539379613","0.17150047444201494","0.4666666666666667","11","12","6","false","10555","8.833333333333334","6","6","false","0","10555","303216356"
"5.5092614866490255","0.7397985753887084","0.18151253165662387","0.4","11","10","5","false","15850","13.2","5","5","false","0","15850","60896720"
"5.825354823189801","3.6067631938826246","0.17166336306574165","0.1","11","10","5","false","19101","5.8","5","5","false","0","19101","222918865"
"5.771950926148665","0.0","0.17325164624489456","1.0","11","6","3","false","20533","9.666666666666666","3","3","false","0","20533","0"
"5.111859514072648","6.724324999100281","0.19562352941176472","0.16666666666666666","10","26","13","false","21943","8.615384615384615","13","13","false","0","21943","562069309"
"5.772191484243445","0.0","0.1732444259220671","1.0","11","4","2","false","22603","12.5","2","2","false","0","22603","0"
"5.771710368053885","8.935070074797027E-5","0.17325886716959113","0.8333333333333334","11","8","4","false","23513","7.75","4","4","false","0","23513","4631"
"4.886937695453452","26.362337281813087","0.20462712281565346","0.1111111111111111","10","38","19","false","25034","8.631578947368421","19","19","false","0","25034","2147119541"
"5.752706278566274","0.0","0.17383122856903904","1.0","11","6","3","false","1280","13.666666666666666","3","3","false","0","1280","0"
"5.784700505171999","0.0","0.17286979664823054","1.0","11","6","3","false","5851","12.666666666666666","3","3","false","0","5851","0"
"5.403897041135434","4.4346240761126925","0.18505163817663817","0.42857142857142855","11","16","8","false","11591","10.5","8","8","false","0","11591","334745579"
"5.076016357950445","19.197844939935862","0.19700488128524712","0.15","10","32","16","false","13520","8.8125","16","16","false","0","13520","1469539064"
"5.453211450565312","1.659508565283718","0.1833781816577705","0.3181818181818182","11","24","12","false","16921","7.583333333333333","12","12","false","0","16921","229488274"
"5.23863363002165","2.9144899420499697","0.19088947054231528","0.3888888888888889","11","18","9","false","21646","13.0","9","9","false","0","21646","365272224"
"5.1366369978349775","5.134133383278966","0.1946799044630731","0.2692307692307692","10","26","13","false","17559","11.692307692307692","13","13","false","0","17559","550819027"
"5.511185951407265","0.6585287661002756","0.18144914884329985","0.4666666666666667","11","12","6","false","1674","10.166666666666666","6","6","false","0","1674","71176457"
"5.54390185229733","1.3669261854093402","0.1803783736874078","0.4","11","10","5","false","3323","9.2","5","5","false","0","3323","105449036"
"5.837623286023574","0.06038875028613069","0.17130259199736267","0.7","11","10","5","false","8680","10.4","5","5","false","0","8680","8393022"
"4.772432042338225","14.993019346763994","0.20953677100660315","0.15714285714285714","10","42","21","false","9184","9.666666666666666","21","21","false","0","9184","2192784506"
"5.28145297089247","13.26696332144866","0.1893418355727625","0.15384615384615385","11","26","13","false","13813","7.846153846153846","13","13","false","0","13813","1142645235"
"5.363002165022853","2.867823500601202","0.1864627253969678","0.2909090909090909","11","22","11","false","19204","7.454545454545454","11","11","false","0","19204","309772681"
"5.838104402213134","0.008218115085809245","0.17128847500927108","0.6666666666666666","11","6","3","false","19206","12.666666666666666","3","3","false","0","19206","1382356"
"4.938176569641568","8.280522077470417","0.2025038971161341","0.17777777777777778","10","20","10","false","19657","11.1","10","10","false","0","19657","682009787"
"4.84652393553043","27.25136001792158","0.20633344914875665","0.12666666666666668","10","50","25","false","20373","9.96","25","25","false","0","20373","2356454327"
"5.144094298773154","4.303628955101889","0.1943976805087916","0.2727272727272727","11","24","12","false","23204","10.833333333333334","12","12","false","0","23204","473142271"
"6.058455617031513","0.0","0.1650585666071074","1.0","12","6","3","false","409","9.0","3","3","false","0","409","0"
"5.706519124368535","1.2629761296448376","0.17523817553326027","0.3333333333333333","11","6","3","false","2474","13.0","3","3","false","0","2474","101068319"
"4.979552561943709","30.84693757995307","0.20082125603864734","0.09803921568627451","10","36","18","false","4241","8.0","18","18","false","0","4241","2732627697"
"6.058455617031513","0.0","0.1650585666071074","1.0","12","6","3","false","6746","9.0","3","3","false","0","6746","0"
"5.700264613904258","6.543503797462759","0.17543045239702904","0.3333333333333333","11","8","4","false","10476","9.5","4","4","false","0","10476","478531624"
"5.647101274957902","1.527170917045192","0.17708200212992548","0.3333333333333333","11","8","4","false","16568","8.25","4","4","false","0","16568","128983763"
"5.6420495549675245","21.232192824214284","0.17724055598192207","0.23809523809523808","11","14","7","false","21771","8.714285714285714","7","7","false","0","21771","2005592630"
"5.418089968727448","0.9758327672863094","0.18456688718199174","0.3333333333333333","11","6","3","false","24620","10.0","3","3","false","0","24620","108541506"
"6.198460428193409","0.0","0.16133038382427137","0.0","12","2","1","false","2081","11.0","1","1","false","0","2081","0"
"6.198460428193409","0.0","0.16133038382427137","0.0","12","2","1","false","2664","11.0","1","1","false","0","2664","0"
"5.231416887178254","8.873568130647541","0.19115280268542786","0.14285714285714285","10","30","15","false","12212","6.6","15","15","false","0","12212","784047002"
"6.061823430358432","0.0","0.1649668637644351","1.0","11","4","2","false","13528","13.0","2","2","false","0","13528","0"
"6.061823430358432","0.0","0.1649668637644351","1.0","11","4","2","false","14628","13.0","2","2","false","0","14628","0"
"5.929275920134713","5.237181501871397","0.1686546575787082","0.1388888888888889","11","18","9","false","22574","5.111111111111111","9","9","false","0","22574","466082934"
"6.198460428193409","0.0","0.16133038382427137","0.0","12","2","1","false","25872","11.0","1","1","false","0","25872","0"
"4.87057974500842","15.077265517349923","0.20531436756062627","0.14285714285714285","10","28","14","false","1545","9.785714285714286","14","14","false","0","1545","1304982854"
"5.783978830887659","0.0","0.17289136582931292","1.0","11","8","4","false","2202","9.5","4","4","false","0","2202","0"
"6.231176329083474","0.0","0.16048334169787282","0.0","11","2","1","false","15206","15.0","1","1","false","0","15206","0"
"5.783978830887659","0.0","0.17289136582931292","1.0","11","8","4","false","17233","9.5","4","4","false","0","17233","0"
"5.782054366129421","0.4102902998384404","0.17294890996838075","0.3333333333333333","11","6","3","false","18158","8.0","3","3","false","0","18158","37049117"
"6.121000721674284","0.0","0.16337197877775594","1.0","11","4","2","false","21317","9.0","2","2","false","0","21317","0"
"5.783978830887659","0.0","0.17289136582931292","1.0","11","8","4","false","24271","9.5","4","4","false","0","24271","0"
"5.535001202790474","0.052986388062874104","0.18066843409100788","0.6666666666666666","11","8","4","false","8547","8.25","4","4","false","0","8547","7394474"
"5.045465479913399","13.437566488967587","0.1981977686659674","0.1523809523809524","10","30","15","false","10791","7.8","15","15","false","0","10791","1186202837"
"5.701467404378158","0.0","0.17539344331462806","1.0","11","4","2","false","10919","14.5","2","2","false","0","10919","0"
"4.6240076978590325","32.685702889870804","0.2162626157527833","0.05847953216374269","9","38","19","false","11275","8.210526315789474","19","19","false","0","11275","3155665673"
"5.613663699783498","0.0","0.17813678436750086","1.0","11","6","3","false","15600","9.333333333333334","3","3","false","0","15600","0"
"5.106086119797931","1.9425291801437137","0.1958447187411665","0.6","10","12","6","false","15608","13.833333333333334","6","6","false","0","15608","280143890"
"5.87033918691364","0.0","0.17034790804409294","0.0","11","2","1","false","16644","14.0","1","1","false","0","16644","0"
"5.151070483521771","2.8690092328084824","0.1941344043338159","0.2857142857142857","10","16","8","false","24568","7.0","8","8","false","0","24568","224279477"
"5.186191965359634","0.9500980086548704","0.1928197040679067","0.4","10","10","5","false","25996","10.6","5","5","false","0","25996","109412694"
"5.388260764974741","2.5675344394389445","0.18558864235010492","0.4","10","12","6","false","26098","7.333333333333333","6","6","false","0","26098","225409072"
"5.91363964397402","0.0","0.16910059797420982","1.0","11","6","3","false","1059","9.0","3","3","false","0","1059","0"
"5.183786384411835","11.109795666543382","0.19290918372082233","0.1619047619047619","11","30","15","false","6154","7.466666666666667","15","15","false","0","6154","1160891838"
"5.381284580226125","1.4105249796262889","0.18582923558337058","0.6","11","12","6","false","7725","12.5","6","6","false","0","7725","258746389"
"5.91363964397402","0.0","0.16910059797420982","1.0","11","6","3","false","11125","9.0","3","3","false","0","11125","0"
"6.045224921818619","0.0","0.16541981695185037","0.0","11","2","1","false","13705","15.0","1","1","false","0","13705","0"
"5.2610055328361796","9.233148469913377","0.1900777320530407","0.18681318681318682","10","28","14","false","15435","11.071428571428571","14","14","false","0","15435","986539595"
"6.04257878277604","3.2828191047117667","0.16549225685735897","0.23809523809523808","11","14","7","false","16039","4.285714285714286","7","7","false","0","16039","247073409"
"6.04378157324994","0.0","0.16545932176405032","1.0","11","4","2","false","17821","11.0","2","2","false","0","17821","0"
"4.708443589126774","20.619732110566012","0.21238440709140144","0.16483516483516483","10","28","14","false","18540","10.357142857142858","14","14","false","0","18540","1934332519"
"5.9138802020688","0.0","0.16909371949235275","1.0","11","4","2","false","20536","12.0","2","2","false","0","20536","0"
"5.411113783978831","3.855796034396396","0.184804836845381","0.16666666666666666","10","18","9","false","23529","5.444444444444445","9","9","false","0","23529","305336005"
"4.687033918691364","10.676695907791443","0.21335454732087866","0.19696969696969696","11","24","12","false","10588","13.5","12","12","false","0","10588","1068990424"
"5.346884772672601","0.6517486436972351","0.1870247896702209","0.35714285714285715","11","16","8","false","3916","7.5","8","8","false","0","3916","60053238"
"5.2607649747414005","6.290841531262817","0.1900864237047876","0.17857142857142858","11","16","8","false","4525","7.25","8","8","false","0","4525","590463351"
"4.445273033437575","42.85152215185766","0.2249580605011094","0.05555555555555555","10","56","28","false","4952","9.428571428571429","28","28","false","0","4952","3694225617"
"5.56410873225884","0.012061665016153265","0.17972330306960657","0.8333333333333334","11","8","4","false","5352","8.0","4","4","false","0","5352","1922654"
"5.638441183545826","0.0","0.17735398267844193","1.0","12","6","3","false","5729","8.0","3","3","false","0","5729","0"
"4.9158046668270385","6.517094085470655","0.20342549547345243","0.2777777777777778","10","18","9","false","10490","11.333333333333334","9","9","false","0","10490","593446804"
"4.961029588645658","11.584718070322898","0.20157106143626047","0.13636363636363635","10","24","12","false","12101","9.333333333333334","12","12","false","0","12101","1057241442"
"4.082511426509502","114.71359512252873","0.24494726297802136","0.05757575757575758","10","90","45","false","13801","11.066666666666666","45","45","false","0","13801","11607444175"
"5.079143613182584","1.7528249205303266","0.19688358435161502","0.3","10","10","5","false","15311","12.2","5","5","false","0","15311","162541205"
"4.791436131825836","11.927198167309857","0.2087056933427051","0.25757575757575757","10","24","12","false","21754","12.333333333333334","12","12","false","0","21754","1257065791"
"4.627856627375511","23.31392610109351","0.21608275288491527","0.11904761904761904","10","42","21","false","23134","10.761904761904763","21","21","false","0","23134","2356528427"
"5.272311763290835","3.098924642362187","0.18967011908564127","0.23809523809523808","11","14","7","false","24614","8.857142857142858","7","7","false","0","24614","338506161"
"6.298773153716622","0.20679778614377206","0.1587610754659334","0.8","11","10","5","false","4493","7.2","5","5","false","0","4493","44517324"
"5.664180899687275","2.4930840073250065","0.1765480336362864","0.3","11","10","5","false","14627","7.6","5","5","false","0","14627","271995147"
"6.298532595621842","0.29998716410860876","0.1587671389833098","0.6","11","12","6","false","23720","6.166666666666667","6","6","false","0","23720","60298085"
"6.728409910993505","0.8389798114107887","0.14862352520557742","0.6","11","10","5","false","930","5.2","5","5","false","0","930","116634641"
"6.7296127014674045","0.0","0.1485969615728329","0.0","11","2","1","false","3946","10.0","1","1","false","0","3946","0"
"6.729372143372625","0.0","0.14860227353971545","1.0","11","4","2","false","4760","8.0","2","2","false","0","4760","0"
"6.728650469088285","0.0","0.1486182117192807","1.0","11","8","4","false","17189","6.5","4","4","false","0","17189","0"
"6.171277363483282","0.0","0.16204100725033133","1.0","12","4","2","false","10463","13.0","2","2","false","0","10463","0"
"6.199903776762088","0.0","0.16129282582547627","0.0","12","2","1","false","10526","20.0","1","1","false","0","10526","0"
"6.0223719028145295","0.0","0.16604753345316559","1.0","12","6","3","false","11788","10.333333333333334","3","3","false","0","11788","0"
"6.030550878037046","3.4593091464977728","0.16582233036818383","0.2","11","12","6","false","17746","6.0","6","6","false","0","17746","263886057"
"6.199903776762088","0.0","0.16129282582547627","0.0","12","2","1","false","18189","20.0","1","1","false","0","18189","0"
"6.199903776762088","0.0","0.16129282582547627","0.0","12","2","1","false","21438","20.0","1","1","false","0","21438","0"
"6.073610777002646","0.0","0.16464670468948037","1.0","12","4","2","false","22611","13.0","2","2","false","0","22611","0"
"5.489776280971855","16.240348781368123","0.18215678541694053","0.09523809523809523","11","30","15","false","26038","6.133333333333334","15","15","false","0","26038","1269931784"
"5.416646620158768","0.9747379797045359","0.18461606785983925","0.5","11","10","5","false","4195","10.0","5","5","false","0","4195","99451294"
"5.344719749819581","2.609630589037333","0.18710054910432983","0.3333333333333333","11","8","4","false","7069","11.5","4","4","false","0","7069","225511442"
"5.417849410632668","0.0","0.18457508214190568","1.0","11","4","2","false","9098","20.0","2","2","false","0","9098","0"
"5.06495068559057","9.503212052051191","0.1974352885300404","0.06666666666666667","10","20","10","false","17721","8.0","10","10","false","0","17721","752348687"
"5.324031753668511","6.168927460973238","0.18782757997469726","0.3","11","10","5","false","21723","11.6","5","5","false","0","21723","500871329"
"5.556170315131104","0.0","0.17998008399359225","0.0","11","2","1","false","24587","25.0","1","1","false","0","24587","0"
"5.864084676449362","1.4803963675033103","0.1705295975714813","0.0","11","4","2","false","7895","5.5","2","2","false","0","7895","92689546"
"5.784219388982439","0.0","0.17288417550426283","1.0","11","4","2","false","11863","6.5","2","2","false","0","11863","0"
"5.448159730574933","0.6697541139456376","0.18354821617802897","0.3333333333333333","10","6","3","false","12110","9.666666666666666","3","3","false","0","12110","51411735"
"4.47822949242242","44.55870590624497","0.22330253545337345","0.11","9","50","25","false","1000","11.44","25","25","false","0","1000","4618105638"
"5.267741159490017","8.389392404365427","0.18983468809936982","0.1111111111111111","10","18","9","false","1149","7.777777777777778","9","9","false","0","1149","710349619"
"4.929757036324272","3.332164810523331","0.20284975357439128","0.4222222222222222","10","20","10","false","1694","17.9","10","10","false","0","1694","527586275"
"4.736588886216021","27.750973920114525","0.2111223971559167","0.08088235294117647","10","34","17","false","2115","7.882352941176471","17","17","false","0","2115","2213512307"
"4.899446716382006","10.871975192680678","0.204104679137821","0.18128654970760233","10","38","19","false","4575","8.263157894736842","19","19","false","0","4575","1140418973"
"5.125090209285543","4.398137527731417","0.19511851678009856","0.4222222222222222","10","20","10","false","5605","9.6","10","10","false","0","5605","472098865"
"5.284820784219389","0.0","0.18922117529245755","1.0","10","12","6","false","6288","13.5","6","6","false","0","6288","0"
"5.069761847486168","3.5295187980039393","0.1972479240806643","0.3333333333333333","10","14","7","false","12016","13.857142857142858","7","7","false","0","12016","295450334"
"5.28241520327159","4.3506169733264946","0.18930734550753678","0.4666666666666667","10","20","10","false","12070","9.7","10","10","false","0","12070","550541017"
"5.309357709886938","11.342410816568519","0.18834669928865932","0.19696969696969696","10","24","12","false","13469","9.333333333333334","12","12","false","0","13469","1509573978"
"4.75944190522011","12.717582111334611","0.21010866818296692","0.3111111111111111","10","20","10","false","16101","13.0","10","10","false","0","16101","1409073368"
"5.36853500120279","0.0","0.18627055607832593","1.0","10","4","2","false","18250","22.0","2","2","false","0","18250","0"
"5.47798893432764","0.0","0.18254874407166696","0.0","10","2","1","false","20667","25.0","1","1","false","0","20667","0"
"4.595621842675006","29.726684033613825","0.21759840871021777","0.5105820105820106","10","56","28","false","20716","23.178571428571427","28","28","false","0","20716","3099260829"
"4.838344960307914","6.543922748715643","0.20668224531397603","0.2777777777777778","10","18","9","false","23107","13.666666666666666","9","9","false","0","23107","680897814"
"4.791195573731056","11.808196073582284","0.20871617211427426","0.2222222222222222","10","18","9","false","23344","13.555555555555555","9","9","false","0","23344","997891762"
"4.5179215780611015","21.720480835781075","0.22134071668175284","0.17647058823529413","10","34","17","false","23939","13.117647058823529","17","17","false","0","23939","2131871554"
"5.126292999759442","0.7600081551712905","0.19507273580478648","0.7619047619047619","10","14","7","false","25402","12.428571428571429","7","7","false","0","25402","104111935"
"5.284099109935049","0.4601326928918282","0.18924701811891106","0.3333333333333333","10","8","4","false","25948","13.5","4","4","false","0","25948","53611064"
"5.0134712533076735","5.235019921062181","0.19946259776402286","0.21212121212121213","10","24","12","false","6963","16.916666666666668","12","12","false","0","6963","699276612"
"5.445994707721915","0.0","0.18362118468130217","1.0","11","6","3","false","8374","12.666666666666666","3","3","false","0","8374","0"
"5.445994707721915","0.0","0.18362118468130217","1.0","11","6","3","false","17465","12.666666666666666","3","3","false","0","17465","0"
"4.597546307433245","51.34430066858486","0.21750732524068647","0.06153846153846154","10","52","26","false","19865","9.23076923076923","26","26","false","0","19865","4120350769"
"4.691363964397402","7.549501351760527","0.21315762485898881","0.24444444444444444","11","20","10","false","3006","15.1","10","10","false","0","3006","708253234"
"4.879239836420496","2.59504727569382","0.20494995809298427","0.35714285714285715","11","16","8","false","3630","13.125","8","8","false","0","3630","282837236"
"4.502285301900409","39.930280184647025","0.22210942509083137","0.10826210826210826","11","54","27","false","5901","10.555555555555555","27","27","false","0","5901","3801885563"
"4.622564349290354","8.359467960143714","0.21633014154870941","0.2857142857142857","11","28","14","false","5953","16.5","14","14","false","0","5953","1095095228"
"5.105605003608371","4.273799990403476","0.19586317376554846","0.26666666666666666","11","20","10","false","7911","9.7","10","10","false","0","7911","436549541"
"5.43396680298292","0.0","0.18402762406481032","1.0","11","6","3","false","8730","11.0","3","3","false","0","8730","0"
"5.226846283377435","1.9607656677698846","0.1913199558173785","0.23809523809523808","11","14","7","false","10406","9.285714285714286","7","7","false","0","10406","249803117"
"4.813086360356026","0.6446719514554904","0.20776689324270292","0.6666666666666666","11","12","6","false","12874","21.833333333333332","6","6","false","0","12874","122758697"
"5.43396680298292","0.0","0.18402762406481032","1.0","11","6","3","false","13177","11.0","3","3","false","0","13177","0"
"4.980995910512389","1.2611508968579985","0.20076306384622813","0.4166666666666667","11","18","9","false","16817","11.666666666666666","9","9","false","0","16817","162320233"
"5.448881404859273","0.9906399242049692","0.18352390622930556","0.4","11","10","5","false","19723","7.8","5","5","false","0","19723","88626569"
"5.377435650709646","1.0424752782635818","0.1859622438937103","0.3333333333333333","11","14","7","false","24885","7.142857142857143","7","7","false","0","24885","120684026"
"6.410151551599712","0.0","0.15600255188201298","0.0","11","2","1","false","13653","6.0","1","1","false","0","13653","0"
"6.409910993504932","0.0","0.15600840651504916","1.0","11","4","2","false","22599","5.0","2","2","false","0","22599","0"
"5.419773875390907","16.794263833590605","0.18450954283177987","0.1111111111111111","10","18","9","false","3265","7.888888888888889","9","9","false","0","3265","1117208236"
"6.488814048592735","0.88636460457366","0.15411136650107513","0.3333333333333333","12","6","3","false","3998","6.0","3","3","false","0","3998","65726988"
"6.489054606687515","0.0","0.15410565338276183","1.0","12","4","2","false","8513","9.0","2","2","false","0","8513","0"
"6.371902814529709","0.0","0.15693899124131683","1.0","12","4","2","false","10501","12.0","2","2","false","0","10501","0"
"6.36997834977147","2.4209953617898816","0.15698640483383686","0.3333333333333333","12","6","3","false","13029","9.333333333333334","3","3","false","0","13029","185026194"
"6.15371662256435","0.0","0.16250342050740785","1.0","11","4","2","false","13622","12.0","2","2","false","0","13622","0"
"6.489054606687515","0.0","0.15410565338276183","1.0","12","6","3","false","13682","7.0","3","3","false","0","13682","0"
"5.649506855905702","7.143337085115947","0.17700659995741963","0.19047619047619047","11","14","7","false","16324","8.142857142857142","7","7","false","0","16324","556196751"
"5.379360115467885","3.306322557586944","0.1858957159466953","0.23809523809523808","11","14","7","false","16640","7.428571428571429","7","7","false","0","16640","424569343"
"6.489054606687515","0.0","0.15410565338276183","1.0","12","6","3","false","16749","7.0","3","3","false","0","16749","0"
"6.489054606687515","0.0","0.15410565338276183","1.0","12","6","3","false","26059","7.0","3","3","false","0","26059","0"
"5.975463074332452","6.118004663542794","0.16735104669887277","0.16666666666666666","12","18","9","false","26065","5.222222222222222","9","9","false","0","26065","474957604"
"6.440221313447197","0.0","0.15527416704019126","1.0","12","4","2","false","580","3.0","2","2","false","0","580","0"
"6.440221313447197","0.0","0.15527416704019126","1.0","12","4","2","false","6431","3.0","2","2","false","0","6431","0"
"4.987972095261005","4.145861556439927","0.20048227634434532","0.3111111111111111","10","20","10","false","1877","10.0","10","10","false","0","1877","501299095"
"4.986047630502767","11.609847034829443","0.20055965648670815","0.11029411764705882","10","34","17","false","2042","6.0","17","17","false","0","2042","992462827"
"4.939138802020688","8.92610986665682","0.20246444574323008","0.2222222222222222","10","18","9","false","15880","10.0","9","9","false","0","15880","700642247"
"5.164782294924224","3.3153737058557087","0.1936190032603633","0.21428571428571427","10","16","8","false","16967","10.75","8","8","false","0","16967","324241151"
"5.985325956218427","0.0","0.1670752783248262","1.0","11","6","3","false","19710","10.0","3","3","false","0","19710","0"
"5.336300216502285","1.995455101433077","0.18739575350493623","0.4666666666666667","10","12","6","false","20014","10.666666666666666","6","6","false","0","20014","176682876"
"5.76040413759923","0.0","0.17359893092792117","1.0","10","6","3","false","23163","11.666666666666666","3","3","false","0","23163","0"
"5.985325956218427","0.0","0.1670752783248262","1.0","11","6","3","false","23225","10.0","3","3","false","0","23225","0"
"5.985807072407987","0.0","0.16706184945545152","0.0","11","2","1","false","3683","17.0","1","1","false","0","3683","0"
"5.985807072407987","0.0","0.16706184945545152","0.0","11","2","1","false","3845","17.0","1","1","false","0","3845","0"
"5.733702189078662","0.0","0.17440738409901407","1.0","10","4","2","false","6748","13.0","2","2","false","0","6748","0"
"5.985807072407987","0.0","0.16706184945545152","0.0","11","2","1","false","14664","17.0","1","1","false","0","14664","0"
"5.985807072407987","0.0","0.16706184945545152","0.0","11","2","1","false","16065","17.0","1","1","false","0","16065","0"
"5.985807072407987","0.0","0.16706184945545152","0.0","11","2","1","false","16963","17.0","1","1","false","0","16963","0"
"5.985325956218427","1.0907924479113005","0.1670752783248262","0.0","11","4","2","false","20650","9.0","2","2","false","0","20650","70952816"
"5.095020447438056","19.932869544112737","0.19627006610009443","0.06666666666666667","11","20","10","false","3804","7.1","10","10","false","0","3804","1474760898"
"5.768342554726966","0.0","0.17336002335376788","1.0","11","4","2","false","4032","7.0","2","2","false","0","4032","0"
"5.296127014674044","3.5485903491287414","0.1888172238372093","0.1","11","10","5","false","5194","6.8","5","5","false","0","5194","269586200"
"5.722877074813567","0.0","0.17473728457335014","1.0","11","4","2","false","23137","11.0","2","2","false","0","23137","0"
"6.015876834255472","0.06287953217786527","0.1662268074216251","0.6666666666666666","11","6","3","false","11495","7.666666666666667","3","3","false","0","11495","6848656"
"5.309598267981718","7.134141581166367","0.18833816600217468","0.05714285714285714","10","30","15","false","12842","4.466666666666667","15","15","false","0","12842","603776079"
"5.637719509261487","0.0","0.17737668544120155","1.0","11","8","4","false","495","8.75","4","4","false","0","495","0"
"5.71638200625451","0.0","0.17493582460127088","0.0","11","2","1","false","2742","16.0","1","1","false","0","2742","0"
"5.71614144815973","0.0","0.17494318660045452","1.0","11","4","2","false","3965","9.0","2","2","false","0","3965","0"
"5.71614144815973","0.0","0.17494318660045452","1.0","11","4","2","false","5622","9.0","2","2","false","0","5622","0"
"5.71638200625451","0.0","0.17493582460127088","0.0","11","2","1","false","7855","16.0","1","1","false","0","7855","0"
"5.71638200625451","0.0","0.17493582460127088","0.0","11","2","1","false","8928","16.0","1","1","false","0","8928","0"
"4.80322347847005","18.3588055052456","0.2081935193068563","0.15555555555555556","11","20","10","false","8968","13.6","10","10","false","0","8968","1768428043"
"5.583112821746452","0.3062556424570088","0.17911155155327674","0.6","11","10","5","false","9458","7.8","5","5","false","0","9458","28765573"
"5.242242001443349","0.9897971423334101","0.1907580763582966","0.4666666666666667","10","12","6","false","17968","9.0","6","6","false","0","17968","78940192"
"5.71638200625451","0.0","0.17493582460127088","0.0","11","2","1","false","18375","16.0","1","1","false","0","18375","0"
"4.830165985085398","11.587150910965253","0.20703222272025498","0.16666666666666666","11","18","9","false","8335","10.88888888888889","9","9","false","0","8335","957487693"
"5.644695694010103","0.07186671234237317","0.17715746857021097","0.0","12","4","2","false","1104","5.5","2","2","false","0","1104","4678292"
"5.829925426990618","0.0","0.17152878068908603","0.0","12","2","1","false","5427","9.0","1","1","false","0","5427","0"
"5.28313687755593","0.0","0.1892814862034423","1.0","11","8","4","false","13322","14.5","4","4","false","0","13322","0"
"5.829925426990618","0.0","0.17152878068908603","0.0","12","2","1","false","13529","9.0","1","1","false","0","13529","0"
"5.273995669954294","4.5734773067908865","0.18960956029921547","0.4166666666666667","11","18","9","false","18619","8.777777777777779","9","9","false","0","18619","565624976"
"5.274236228049074","3.8191422832224236","0.18960091220068415","0.5357142857142857","11","16","8","false","18751","9.875","8","8","false","0","18751","516980261"
"6.272552321385614","0.9533564195710292","0.15942473633748802","0.6190476190476191","12","14","7","false","6494","7.142857142857143","7","7","false","0","6494","125615751"
"6.653596343516959","0.22337344605340667","0.15029465996601468","0.6","13","12","6","false","2526","7.333333333333333","6","6","false","0","2526","32544150"
"5.852056771710368","1.2397351525870102","0.17088009207876023","0.6","12","12","6","false","6364","7.5","6","6","false","0","6364","148696892"
"5.824392590810681","7.444256788430445","0.1716917231125062","0.35555555555555557","12","20","10","false","6857","6.4","10","10","false","0","6857","603646701"
"6.443108010584556","0.5079021027814568","0.1552045997610514","0.6666666666666666","13","12","6","false","7853","7.0","6","6","false","0","7853","91498107"
"6.443108010584556","0.5079021027814568","0.1552045997610514","0.6666666666666666","13","12","6","false","14976","7.0","6","6","false","0","14976","91498107"
"6.6244888140485925","5.256120956062893","0.1509550439392839","0.15555555555555556","13","20","10","false","24781","4.5","10","10","false","0","24781","435764322"
"6.294443108010585","0.0","0.15887028968890926","1.0","12","4","2","false","321","8.0","2","2","false","0","321","0"
"6.555208082751984","1.4075820080269204","0.15255045871559633","0.4","13","10","5","false","21853","7.2","5","5","false","0","21853","87236399"
"7.248015395718066","0.0","0.13796880185861268","1.0","13","4","2","false","884","7.0","2","2","false","0","884","0"
"7.6237671397642535","0.0","0.13116874921115737","1.0","14","6","3","false","5469","5.333333333333333","3","3","false","0","5469","0"
"7.6237671397642535","0.0","0.13116874921115737","1.0","14","6","3","false","5575","5.333333333333333","3","3","false","0","5575","0"
"7.6242482559538125","0.0","0.13116047201363035","0.0","14","2","1","false","10183","10.0","1","1","false","0","10183","0"
"6.662256434929035","1.322778880526979","0.15009929590178733","0.3333333333333333","12","12","6","false","10966","6.333333333333333","6","6","false","0","10966","115751287"
"7.6237671397642535","0.0","0.13116874921115737","1.0","14","6","3","false","16624","5.333333333333333","3","3","false","0","16624","0"
"6.474621121000721","4.423224540420075","0.15444919190042727","0.16666666666666666","12","8","4","false","24699","4.5","4","4","false","0","24699","296834014"
"5.359874909790714","1.7270676882281983","0.18657151833400656","0.47619047619047616","11","14","7","false","14308","11.142857142857142","7","7","false","0","14308","263700406"
"5.647822949242242","0.8660422863458247","0.17705937473379335","0.3333333333333333","11","6","3","false","5166","9.333333333333334","3","3","false","0","5166","92528181"
"5.274236228049074","7.477355552542437","0.18960091220068415","0.19696969696969696","11","24","12","false","5597","7.583333333333333","12","12","false","0","5597","741644425"
"5.177050757757999","1.9207234417492394","0.19316016913712186","0.3333333333333333","11","14","7","false","9066","10.714285714285714","7","7","false","0","9066","222440652"
"5.994467163820063","0.21878181565743435","0.16682049841486415","0.7333333333333333","12","12","6","false","20787","9.5","6","6","false","0","20787","49452553"
"5.537887899927832","7.795240824344337","0.18057425828591286","0.17142857142857143","12","30","15","false","23836","5.466666666666667","15","15","false","0","23836","717821725"
"5.766658648063507","0.8028930711684451","0.17341064575337894","0.5","12","16","8","false","25050","7.875","8","8","false","0","25050","119724633"
"5.729131585277845","4.9417954847535555","0.17454652334565","0.17777777777777778","11","20","10","false","5287","6.6","10","10","false","0","5287","413911238"
"6.307433245128698","0.08545922289873091","0.15854309687261633","0.7","12","10","5","false","17273","8.2","5","5","false","0","17273","19705476"
"4.902333413519365","6.921351137510995","0.20398449384169978","0.14285714285714285","10","14","7","false","9283","22.714285714285715","7","7","false","0","9283","789686189"
"5.335337984123166","0.0","0.18742955047567517","1.0","12","6","3","false","953","12.333333333333334","3","3","false","0","953","0"
"5.278325715660332","0.38453363634190063","0.1894540151307994","0.3","12","10","5","false","17794","9.0","5","5","false","0","17794","46470072"
"6.273995669954294","0.0","0.1593880602737625","0.0","12","2","1","false","114","12.0","1","1","false","0","114","0"
"6.273995669954294","0.0","0.1593880602737625","0.0","12","2","1","false","2348","12.0","1","1","false","0","2348","0"
"6.273995669954294","0.0","0.1593880602737625","0.0","12","2","1","false","6631","12.0","1","1","false","0","6631","0"
"5.838826076497474","1.375829306088296","0.1712673038892551","0.3","12","10","5","false","8854","7.8","5","5","false","0","8854","105163402"
"6.537647341833052","0.0","0.1529602237185856","0.0","13","2","1","false","4290","15.0","1","1","false","0","4290","0"
"6.537406783738273","0.0","0.1529658522225493","1.0","13","4","2","false","8200","8.5","2","2","false","0","8200","0"
"6.0928554245850375","0.0","0.1641266582438408","1.0","12","6","3","false","11113","9.333333333333334","3","3","false","0","11113","0"
"6.537406783738273","0.0","0.1529658522225493","1.0","13","4","2","false","12302","8.5","2","2","false","0","12302","0"
"6.537647341833052","0.0","0.1529602237185856","0.0","13","2","1","false","21017","15.0","1","1","false","0","21017","0"
"5.646860716863123","1.693609266140498","0.17708954588054868","0.3","11","10","5","false","23297","7.2","5","5","false","0","23297","125270085"
"2.2222222222222223","0.0","0.44999999999999996","1.0","3","4","2","false","6355","3.5","2","2","false","0","6355","0"
"1.4444444444444444","3.444444444444444","0.6923076923076923","0.1","2","10","5","false","7194","2.2","5","5","false","0","7194","248"
"2.2222222222222223","0.0","0.44999999999999996","1.0","3","4","2","false","20960","3.5","2","2","false","0","20960","0"
"2.3333333333333335","0.0","0.42857142857142855","0.0","3","2","1","false","7542","5.0","1","1","false","0","7542","0"
"2.3333333333333335","0.0","0.42857142857142855","0.0","3","2","1","false","15322","5.0","1","1","false","0","15322","0"
"1.4444444444444444","3.7777777777777777","0.6923076923076923","0.0","2","10","5","false","18415","1.8","5","5","false","0","18415","272"
"6.773875390906904","3.648209891220972","0.1476259810362584","0.3333333333333333","13","6","3","false","23066","3.6666666666666665","3","3","false","0","23066","358285156"
"5.776280971854703","6.9413424391653535","0.17312177244710977","0.2857142857142857","12","14","7","false","3765","6.714285714285714","7","7","false","0","3765","775448722"
"6.7748376232860235","0.0","0.14760501367041864","1.0","13","4","2","false","14500","5.0","2","2","false","0","14500","0"
"7.772191484243445","2.6892405009072444","0.1286638397969606","0.0","14","4","2","false","17918","3.0","2","2","false","0","17918","264361407"
"5.777724320423382","1.3750798553028039","0.17307852444000332","0.5","12","10","5","false","3418","8.8","5","5","false","0","3418","229206634"
"6.242482559538129","1.7256622960132986","0.1601926782273603","0.26666666666666666","12","12","6","false","4798","3.8333333333333335","6","6","false","0","4798","166450975"
"6.656483040654318","0.0","0.15022948212930506","1.0","13","6","3","false","12866","6.0","3","3","false","0","12866","0"
"6.775799855665143","0.0","0.14758405225973656","1.0","13","4","2","false","20196","6.0","2","2","false","0","20196","0"
"1.0","0.0","1.0","0.0","1","2","1","false","2004","1.0","1","1","false","0","2004","0"
"1.0","0.0","1.0","0.0","1","2","1","false","21191","1.0","1","1","false","0","21191","0"
"7.121722395958624","3.547590216810218","0.14041547035973653","0.0","12","4","2","false","21663","4.0","2","2","false","0","21663","299557920"
"6.123887418811643","7.365754691403787","0.16329496798523","0.1","11","10","5","false","14020","3.6","5","5","false","0","14020","621803699"
"8.120038489295165","2.5930199255728534","0.12315212561102058","0.0","13","6","3","false","22203","1.6666666666666667","3","3","false","0","22203","218984110"
"7.123406302622083","0.0","0.14038227745508577","1.0","12","4","2","false","1600","3.5","2","2","false","0","1600","0"
"7.123646860716863","0.0","0.14037753689258095","0.0","12","2","1","false","15905","5.0","1","1","false","0","15905","0"
"7.123406302622083","0.0","0.14038227745508577","1.0","12","4","2","false","21635","3.5","2","2","false","0","21635","0"
"6.15179215780611","5.6561796848524555","0.16255425644234153","0.39285714285714285","12","16","8","false","16543","5.5","8","8","false","0","16543","491746253"
"7.150348809237431","1.9024258512665648","0.1398533171847665","0.3333333333333333","13","8","4","false","238","4.0","4","4","false","0","238","113213676"
"6.15251383209045","2.8010154246542323","0.16253518923991242","0.47619047619047616","12","14","7","false","4793","5.857142857142857","7","7","false","0","4793","321762268"
"5.164782294924224","20.34744827342372","0.1936190032603633","0.15384615384615385","11","26","13","false","6218","6.923076923076923","13","13","false","0","6218","1712755952"
"7.037286504690883","3.2843826057520022","0.14210022561017296","0.2","12","10","5","false","15516","4.4","5","5","false","0","15516","349707207"
"6.158768342554727","0.0","0.16237012733380204","1.0","12","8","4","false","16553","8.0","4","4","false","0","16553","0"
"7.150348809237431","6.535759690103754E-4","0.1398533171847665","0.6666666666666666","13","8","4","false","16563","5.5","4","4","false","0","16563","22583"
"6.158768342554727","0.0","0.16237012733380204","1.0","12","8","4","false","16565","8.0","4","4","false","0","16565","0"
"7.151070483521771","0.0","0.13983920341776834","1.0","13","6","3","false","22964","6.333333333333333","3","3","false","0","22964","0"
"8.14986769304787","0.0","0.12270137843501876","1.0","14","4","2","false","8442","3.0","2","2","false","0","8442","0"
"8.14986769304787","0.0","0.12270137843501876","1.0","14","4","2","false","10412","3.0","2","2","false","0","10412","0"
"1.0","0.0","1.0","0.0","1","2","1","false","8887","1.0","1","1","false","0","8887","0"
"1.0","0.0","1.0","0.0","1","2","1","false","6072","1.0","1","1","false","0","6072","0"
"5.929275920134713","2.557399892479799","0.1686546575787082","0.2545454545454545","12","22","11","false","491","6.636363636363637","11","11","false","0","491","234702677"
"5.736829444310801","2.076475693940892","0.17431231130493124","0.42857142857142855","12","14","7","false","1124","14.857142857142858","7","7","false","0","1124","199122315"
"6.487851816213616","0.0","0.15413422321097514","1.0","12","6","3","false","1818","8.0","3","3","false","0","1818","0"
"5.510704835217705","1.8932070810896406","0.18146499039636807","0.3333333333333333","12","6","3","false","4552","14.0","3","3","false","0","4552","162607050"
"6.4207361077700265","0.0","0.155745382338616","1.0","12","8","4","false","5739","8.0","4","4","false","0","5739","0"
"5.6418089968727445","7.896111005517216","0.17724811324777215","0.4238095238095238","11","42","21","false","6823","11.19047619047619","21","21","false","0","6823","883783863"
"6.016598508539812","1.621078866449014","0.16620686897764983","0.32142857142857145","12","16","8","false","7882","6.0","8","8","false","0","7882","133079802"
"5.643492903536204","2.7060118470977352","0.17719522591645354","0.39285714285714285","11","16","8","false","13328","7.125","8","8","false","0","13328","236022477"
"6.487851816213616","0.0","0.15413422321097514","1.0","12","6","3","false","17039","8.0","3","3","false","0","17039","0"
"5.504209766658648","4.5141945658448295","0.18167912241597833","0.26666666666666666","11","20","10","false","17082","7.5","10","10","false","0","17082","426698540"
"6.4204955496752465","0.570840307164209","0.15575121768452604","0.6","12","10","5","false","22028","6.4","5","5","false","0","22028","41680423"
"6.929035362039933","0.0","0.1443202333009304","0.0","13","2","1","false","23454","11.0","1","1","false","0","23454","0"
"5.661775318739475","0.0","0.17662304554724678","1.0","11","6","3","false","3681","10.666666666666666","3","3","false","0","3681","0"
"6.488332932403176","0.0","0.15412279400860152","1.0","12","4","2","false","7126","9.0","2","2","false","0","7126","0"
"4.991099350493144","21.73691134092233","0.20035666088297668","0.14102564102564102","11","26","13","false","3547","9.23076923076923","13","13","false","0","3547","1520616469"
"5.617272071205196","18.57810151061624","0.17802235450301915","0.11724137931034483","11","60","30","false","449","5.5","30","30","false","0","449","1636411881"
"5.708924705316334","0.28817799044984","0.1751643350750042","0.6666666666666666","12","8","4","false","882","7.75","4","4","false","0","882","27054690"
"5.451046427712292","0.0","0.18345101500441308","1.0","11","4","2","false","1405","19.5","2","2","false","0","1405","0"
"5.990377676208804","0.0","0.16693438278049957","1.0","12","6","3","false","1498","8.0","3","3","false","0","1498","0"
"5.990377676208804","0.0","0.16693438278049957","1.0","12","6","3","false","3033","8.0","3","3","false","0","3033","0"
"5.979071445754149","2.9083219279599644","0.16725005029169182","0.1","12","10","5","false","3048","4.2","5","5","false","0","3048","180387805"
"5.990618234303584","0.0","0.1669276793960567","1.0","12","4","2","false","3511","10.5","2","2","false","0","3511","0"
"5.91243685350012","0.0","0.16913499877939622","1.0","12","6","3","false","7091","17.0","3","3","false","0","7091","0"
"5.7120519605484725","0.8335837079100388","0.17506843546009687","0.35714285714285715","12","16","8","false","14707","8.0","8","8","false","0","14707","96883952"
"5.34736588886216","4.001003955763202","0.18700796257141572","0.26666666666666666","12","12","6","false","17245","7.666666666666667","6","6","false","0","17245","342935064"
"5.990858792398364","0.0","0.16692097654995183","0.0","12","2","1","false","18340","13.0","1","1","false","0","18340","0"
"5.56362761606928","3.3204296745126216","0.17973884469041856","0.14285714285714285","11","14","7","false","6804","3.857142857142857","7","7","false","0","6804","236287089"
"6.563146499879721","0.0","0.15236594216178573","1.0","12","4","2","false","12260","4.5","2","2","false","0","12260","0"
"5.657204714938658","1.007528739378535","0.17676574392992303","0.3333333333333333","11","8","4","false","19624","5.25","4","4","false","0","19624","72785753"
"5.632667789271109","1.2388851578734887","0.17753576767029683","0.2","11","10","5","false","22826","6.6","5","5","false","0","22826","85087801"
"6.563146499879721","0.0","0.15236594216178573","1.0","12","4","2","false","25491","4.5","2","2","false","0","25491","0"
"6.563387057974501","0.0","0.15236035771880954","0.0","12","2","1","false","25844","7.0","1","1","false","0","25844","0"
"6.656964156843878","0.0","0.15021862465218805","0.0","12","2","1","false","6184","4.0","1","1","false","0","6184","0"
"5.9603079143613185","1.4652633763845113","0.16777656697743876","0.5","12","8","4","false","19161","7.0","4","4","false","0","19161","91586059"
"5.960548472456098","0.0","0.16776979578658485","1.0","12","6","3","false","21831","9.333333333333334","3","3","false","0","21831","0"
"5.5082992542699065","0.07325022627454396","0.18154423967158703","0.8873403019744484","11","84","42","false","88","38.523809523809526","42","42","false","0","88","72574611"
"5.5082992542699065","0.07325022627454396","0.18154423967158703","0.8873403019744484","11","84","42","false","1995","38.523809523809526","42","42","false","0","1995","72574611"
"5.5082992542699065","0.07325022627454396","0.18154423967158703","0.8873403019744484","11","84","42","false","2338","38.523809523809526","42","42","false","0","2338","72574611"
"5.5082992542699065","0.07325022627454396","0.18154423967158703","0.8873403019744484","11","84","42","false","2530","38.523809523809526","42","42","false","0","2530","72574611"
"5.5082992542699065","0.07325022627454396","0.18154423967158703","0.8873403019744484","11","84","42","false","2535","38.523809523809526","42","42","false","0","2535","72574611"
"5.65119076256916","0.0","0.17695385663204496","1.0","11","62","31","false","4355","40.58064516129032","31","31","false","0","4355","0"
"5.5082992542699065","0.07325022627454396","0.18154423967158703","0.8873403019744484","11","84","42","false","4755","38.523809523809526","42","42","false","0","4755","72574611"
"5.611498676930479","0.0","0.17820551292493678","1.0","12","66","33","false","5210","40.60606060606061","33","33","false","0","5210","0"
"5.5082992542699065","0.07325022627454396","0.18154423967158703","0.8873403019744484","11","84","42","false","6340","38.523809523809526","42","42","false","0","6340","72574611"
"5.5082992542699065","0.07325022627454396","0.18154423967158703","0.8873403019744484","11","84","42","false","7197","38.523809523809526","42","42","false","0","7197","72574611"
"5.5082992542699065","0.07325022627454396","0.18154423967158703","0.8873403019744484","11","84","42","false","7635","38.523809523809526","42","42","false","0","7635","72574611"
"5.611498676930479","0.0","0.17820551292493678","1.0","12","66","33","false","8727","40.60606060606061","33","33","false","0","8727","0"
"5.65119076256916","0.0","0.17695385663204496","1.0","11","62","31","false","9313","40.58064516129032","31","31","false","0","9313","0"
"5.5082992542699065","0.07325022627454396","0.18154423967158703","0.8873403019744484","11","84","42","false","9656","38.523809523809526","42","42","false","0","9656","72574611"
"5.5085398123646865","0.06016846075661155","0.1815363116293288","0.9024390243902439","11","82","41","false","9869","38.80487804878049","41","41","false","0","9869","58312051"
"5.41351936492663","1.756516979545146","0.1847227159616068","0.8460686600221484","11","86","43","false","10350","37.883720930232556","43","43","false","0","10350","230598162"
"5.5082992542699065","0.07325022627454396","0.18154423967158703","0.8873403019744484","11","84","42","false","12507","38.523809523809526","42","42","false","0","12507","72574611"
"5.611498676930479","0.0","0.17820551292493678","1.0","12","66","33","false","12710","40.60606060606061","33","33","false","0","12710","0"
"5.65119076256916","0.0","0.17695385663204496","1.0","11","62","31","false","14648","40.58064516129032","31","31","false","0","14648","0"
"5.5082992542699065","0.07325022627454396","0.18154423967158703","0.8873403019744484","11","84","42","false","14766","38.523809523809526","42","42","false","0","14766","72574611"
"5.5082992542699065","0.07325022627454396","0.18154423967158703","0.8873403019744484","11","84","42","false","15010","38.523809523809526","42","42","false","0","15010","72574611"
"4.84748616790955","29.779869358544403","0.20629249168775743","0.4640561075394506","11","118","59","false","15244","29.864406779661017","59","59","false","0","15244","3990028599"
"5.611498676930479","0.0","0.17820551292493678","1.0","12","66","33","false","15245","40.60606060606061","33","33","false","0","15245","0"
"5.611258118835699","9.172695475447528E-5","0.1782131527051359","0.983957219251337","12","68","34","false","15457","40.205882352941174","34","34","false","0","15457","39618"
"5.5085398123646865","0.06016846075661155","0.1815363116293288","0.9024390243902439","11","82","41","false","15933","38.80487804878049","41","41","false","0","15933","58312051"
"5.5082992542699065","0.07325022627454396","0.18154423967158703","0.8873403019744484","11","84","42","false","16654","38.523809523809526","42","42","false","0","16654","72574611"
"5.5082992542699065","0.07325022627454396","0.18154423967158703","0.8873403019744484","11","84","42","false","17807","38.523809523809526","42","42","false","0","17807","72574611"
"5.5082992542699065","0.07325022627454396","0.18154423967158703","0.8873403019744484","11","84","42","false","18225","38.523809523809526","42","42","false","0","18225","72574611"
"5.17392350252586","5.222762769925887","0.19327692021573367","0.7476190476190476","10","72","36","false","18453","36.138888888888886","36","36","false","0","18453","1005215695"
"5.264373346163098","3.1968508071554576","0.1899561323341254","0.8360071301247772","10","68","34","false","18778","38.0","34","34","false","0","18778","924270192"
"5.65119076256916","0.0","0.17695385663204496","1.0","11","62","31","false","19114","40.58064516129032","31","31","false","0","19114","0"
"5.611498676930479","0.0","0.17820551292493678","1.0","12","66","33","false","19446","40.60606060606061","33","33","false","0","19446","0"
"5.5082992542699065","0.07325022627454396","0.18154423967158703","0.8873403019744484","11","84","42","false","19645","38.523809523809526","42","42","false","0","19645","72574611"
"5.5082992542699065","0.07325022627454396","0.18154423967158703","0.8873403019744484","11","84","42","false","19939","38.523809523809526","42","42","false","0","19939","72574611"
"6.033197017079624","0.0","0.16574960127591706","1.0","12","4","2","false","20346","27.0","2","2","false","0","20346","0"
"5.5085398123646865","0.06016846075661155","0.1815363116293288","0.9024390243902439","11","82","41","false","20576","38.80487804878049","41","41","false","0","20576","58312051"
"5.65119076256916","0.0","0.17695385663204496","1.0","11","62","31","false","21178","40.58064516129032","31","31","false","0","21178","0"
"5.611498676930479","0.0","0.17820551292493678","1.0","12","66","33","false","22504","40.60606060606061","33","33","false","0","22504","0"
"5.611258118835699","9.172695475447528E-5","0.1782131527051359","0.983957219251337","12","68","34","false","23712","40.205882352941174","34","34","false","0","23712","39618"
"5.271830647101275","0.635550667734213","0.1896874287018024","0.5","11","10","5","false","24453","29.2","5","5","false","0","24453","77587047"
"5.357469328842916","5.315655523465348","0.18665529163486147","0.7192307692307692","11","80","40","false","24718","35.1","40","40","false","0","24718","624165098"
"5.8275198460428195","0.0","0.17159958720330237","1.0","12","8","4","false","12308","8.5","4","4","false","0","12308","0"
"5.8272792879480395","0.939774231944772","0.1716066710700132","0.6","12","10","5","false","15935","6.8","5","5","false","0","15935","62971986"
"5.8275198460428195","0.0","0.17159958720330237","1.0","12","8","4","false","18276","8.5","4","4","false","0","18276","0"
"5.749579023334135","1.0366417707958817","0.17392577716413538","0.6","11","10","5","false","18904","11.0","5","5","false","0","18904","89450480"
"6.381044022131345","0.0","0.1567141672321496","1.0","11","8","4","false","2190","5.25","4","4","false","0","2190","0"
"5.596584075054126","0.8063411410756844","0.17868042123361272","0.6","11","12","6","false","6172","7.666666666666667","6","6","false","0","6172","103019708"
"5.596584075054126","0.8063411410756844","0.17868042123361272","0.6","11","12","6","false","8592","7.666666666666667","6","6","false","0","8592","103019708"
"6.381044022131345","0.0","0.1567141672321496","1.0","11","8","4","false","14933","5.25","4","4","false","0","14933","0"
"5.638922299735386","0.0","0.1773388507316241","1.0","12","4","2","false","4249","13.5","2","2","false","0","4249","0"
"5.758720230935771","1.5349202280969565","0.17364969296963115","0.4666666666666667","12","12","6","false","21718","9.666666666666666","6","6","false","0","21718","189418460"
"5.89006495068559","0.0","0.16977741474372066","1.0","12","4","2","false","22290","8.5","2","2","false","0","22290","0"
"5.040413759923021","3.660093517908128","0.1983964110151291","0.34545454545454546","11","22","11","false","23441","11.454545454545455","11","11","false","0","23441","441380343"
"5.930959826798172","0.0","0.16860677347394037","0.0","12","2","1","false","24113","11.0","1","1","false","0","24113","0"
"5.164782294924224","0.04795386833006576","0.1936190032603633","0.8","11","12","6","false","6421","13.5","6","6","false","0","6421","7887468"
"5.0861197979312","0.15456530648117278","0.19661353639502435","0.8","10","12","6","false","8224","16.0","6","6","false","0","8224","25100374"
"5.188116430117874","1.4253697014952167","0.19274818008995223","0.5","11","8","4","false","11182","16.75","4","4","false","0","11182","114660209"
"4.792879480394515","13.845715456882342","0.20864284280265005","0.16374269005847952","10","38","19","false","11696","10.157894736842104","19","19","false","0","11696","1409577327"
"5.614144815973058","5.300347524392052","0.17812151855343217","0.2222222222222222","12","20","10","false","12286","5.8","10","10","false","0","12286","590977180"
"5.9138802020688","1.210662266014804","0.16909371949235275","0.5","12","10","5","false","23423","7.6","5","5","false","0","23423","121802333"
"6.143132066394034","0.9421196872235215","0.16278341230371618","0.6071428571428571","11","16","8","false","500","10.0","8","8","false","0","500","162336936"
"6.612460909309598","0.3657865165995586","0.15122962747380675","0.6666666666666666","12","8","4","false","2085","11.75","4","4","false","0","2085","49237359"
"6.616069280731296","1.3114159209327012E-4","0.15114714758389994","0.8","12","10","5","false","2568","11.8","5","5","false","0","2568","6797"
"6.612220351214819","0.3812009466852574","0.1512351293338669","0.6","12","10","5","false","3099","10.4","5","5","false","0","3099","54330496"
"6.616790955015636","0.0","0.1511306624009307","1.0","12","4","2","false","4468","16.0","2","2","false","0","4468","0"
"6.144575414962714","0.0","0.1627451748032729","1.0","11","6","3","false","4631","16.0","3","3","false","0","4631","0"
"6.6155881645417365","0.0","0.15115813970401076","1.0","12","12","6","false","9892","11.333333333333334","6","6","false","0","9892","0"
"6.616550396920856","0.0","0.1511361570623523","1.0","12","6","3","false","10358","14.666666666666666","3","3","false","0","10358","0"
"6.6153476064469565","0.6908587692455158","0.15116363636363636","0.7142857142857143","12","14","7","false","10458","9.714285714285714","7","7","false","0","10458","71511183"
"6.142169834014915","0.4686098558294717","0.16280891395449026","0.42857142857142855","11","16","8","false","10615","9.125","8","8","false","0","10615","106398098"
"6.6153476064469565","3.1208110226697703E-4","0.15116363636363636","0.8095238095238095","12","14","7","false","11011","10.285714285714286","7","7","false","0","11011","16175"
"6.142650950204475","0.23251519177660018","0.16279616213040923","0.6","11","12","6","false","12074","10.166666666666666","6","6","false","0","12074","53240458"
"6.616790955015636","0.0","0.1511306624009307","1.0","12","4","2","false","13971","19.0","2","2","false","0","13971","0"
"6.246812605244166","0.0","0.16008163894023414","1.0","12","6","3","false","14079","15.333333333333334","3","3","false","0","14079","0"
"6.143853740678374","0.2891821340669876","0.16276429130775255","0.6666666666666666","11","12","6","false","16754","11.166666666666666","6","6","false","0","16754","72005762"
"6.616790955015636","0.0","0.1511306624009307","1.0","12","4","2","false","18783","16.0","2","2","false","0","18783","0"
"6.143853740678374","0.2891821340669876","0.16276429130775255","0.6666666666666666","11","12","6","false","19612","11.166666666666666","6","6","false","0","19612","72005762"
"6.616309838826076","1.960178026881846E-4","0.15114165212332753","0.6666666666666666","12","8","4","false","20552","11.0","4","4","false","0","20552","6773"
"6.616790955015636","0.0","0.1511306624009307","1.0","12","4","2","false","20553","17.0","2","2","false","0","20553","0"
"6.246812605244166","0.0","0.16008163894023414","1.0","12","6","3","false","21032","15.333333333333334","3","3","false","0","21032","0"
"6.616309838826076","1.008079591620799","0.15114165212332753","0.3333333333333333","12","6","3","false","23355","11.0","3","3","false","0","23355","78293829"
"6.144575414962714","0.0","0.1627451748032729","1.0","11","6","3","false","24454","16.666666666666668","3","3","false","0","24454","0"
"6.6146259321626175","0.0020706749958266943","0.15118012874131723","0.5111111111111111","12","20","10","false","25086","8.9","10","10","false","0","25086","84886"
"6.616550396920856","0.0","0.1511361570623523","1.0","12","4","2","false","25180","16.5","2","2","false","0","25180","0"
"6.6155881645417365","0.0","0.15115813970401076","1.0","12","12","6","false","25785","11.333333333333334","6","6","false","0","25785","0"
"7.066875150348809","1.445015095422778","0.1415052592163938","0.16666666666666666","12","8","4","false","10539","4.25","4","4","false","0","10539","172592424"
"1.0","0.0","1.0","0.0","1","2","1","false","4254","1.0","1","1","false","0","4254","0"
"1.0","0.0","1.0","0.0","1","2","1","false","9337","1.0","1","1","false","0","9337","0"
"6.582872263651672","0.9041838470448745","0.15190937328704548","0.0","13","4","2","false","1497","4.5","2","2","false","0","1497","72550713"
"5.583593937936011","4.321391062120845","0.17909611821980959","0.32142857142857145","12","16","8","false","6724","6.875","8","8","false","0","6724","372164218"
"7.582631705556892","0.0","0.1318803337457568","0.0","14","2","1","false","16890","2.0","1","1","false","0","16890","0"
"5.744286745248978","0.628089776558806","0.17408601700238702","0.6","12","10","5","false","2630","7.0","5","5","false","0","2630","49868626"
"5.025499158046668","4.8693825191207525","0.19898520894164953","0.3333333333333333","11","14","7","false","7563","11.428571428571429","7","7","false","0","7563","389403975"
"5.2076016357950445","4.706539831724143","0.1920269770879527","0.23636363636363636","11","22","11","false","14403","9.181818181818182","11","11","false","0","14403","538171501"
"6.164541736829444","0.0","0.16221805978303286","1.0","12","6","3","false","17392","9.0","3","3","false","0","17392","0"
"6.161173923502526","1.2642886589250886","0.16230673121974074","0.2857142857142857","12","16","8","false","23503","4.75","8","8","false","0","23503","147429265"
"5.560500360837143","0.0","0.1798399307808782","1.0","11","4","2","false","2558","12.5","2","2","false","0","2558","0"
"5.046908828482079","18.866031726127108","0.19814108674928502","0.09090909090909091","11","22","11","false","21910","7.0","11","11","false","0","21910","1601854314"
"5.517440461871542","0.0","0.1812434600627834","1.0","11","4","2","false","18910","17.5","2","2","false","0","18910","0"
"5.427712292518644","0.9998725508245279","0.184239684439126","0.3","11","10","5","false","2511","10.8","5","5","false","0","2511","77570555"
"6.046668270387299","0.0","0.16538033099936345","0.0","12","2","1","false","10986","11.0","1","1","false","0","10986","0"
"5.786865528025018","5.795958604817657","0.17280512138343865","0.3333333333333333","12","6","3","false","13318","6.666666666666667","3","3","false","0","13318","451186957"
"5.504209766658648","2.674270616248038","0.18167912241597833","0.06666666666666667","11","12","6","false","14051","5.666666666666667","6","6","false","0","14051","192773400"
"6.045706038008179","2.32312514600765","0.16540665287283146","0.0","12","4","2","false","14414","6.5","2","2","false","0","14414","185265729"
"5.9511667067596825","6.124644712140105","0.16803427786086744","0.0","12","6","3","false","22119","6.333333333333333","3","3","false","0","22119","485815167"
"5.524657204714939","0.0","0.18100670556474788","1.0","12","4","2","false","1006","11.5","2","2","false","0","1006","0"
"5.135915323550638","16.642957435238575","0.1947072599531616","0.1388888888888889","10","18","9","false","4351","10.88888888888889","9","9","false","0","4351","1347691201"
"5.471734423863363","9.830741954605106","0.1827574078958938","0.17647058823529413","12","36","18","false","11372","7.0","18","17","false","1","11372","886710921"
"4.656723598749098","13.282987528913669","0.21474325860109517","0.21428571428571427","10","42","21","false","16414","14.666666666666666","21","21","false","0","16414","1901483265"
"5.409910993504932","1.4571214781037394","0.1848459246742852","0.2857142857142857","10","14","7","false","639","10.285714285714286","7","7","false","0","639","144203083"
"5.242482559538129","1.2044552932471848","0.19074932317716697","0.47619047619047616","10","14","7","false","1941","10.714285714285714","7","7","false","0","1941","150240446"
"5.842675006013953","0.0","0.1711544795783926","1.0","11","6","3","false","5227","11.0","3","3","false","0","5227","0"
"5.842675006013953","0.0","0.1711544795783926","1.0","11","6","3","false","7015","11.0","3","3","false","0","7015","0"
"5.838585518402694","0.001775086942552918","0.1712743603477401","0.7","11","10","5","false","9647","8.2","5","5","false","0","9647","136795"
"5.979312003848929","0.0","0.16724332153202445","0.0","11","2","1","false","12852","18.0","1","1","false","0","12852","0"
"5.215058936733221","3.978408986348222","0.19175238710272616","0.24444444444444444","10","20","10","false","15846","8.8","10","10","false","0","15846","454689329"
"5.979312003848929","0.0","0.16724332153202445","0.0","11","2","1","false","16333","18.0","1","1","false","0","16333","0"
"5.5001202790473895","3.6797266311330943","0.18181420573827853","0.17857142857142858","11","16","8","false","16347","7.25","8","8","false","0","16347","344359096"
"5.629299975944191","0.0","0.17764198111191828","0.0","10","2","1","false","4576","22.0","1","1","false","0","4576","0"
"5.235506374789511","1.3836773179268584","0.19100349200514613","0.1","10","10","5","false","6941","9.6","5","5","false","0","6941","124972488"
"5.629299975944191","0.0","0.17764198111191828","0.0","10","2","1","false","7206","22.0","1","1","false","0","7206","0"
"5.431801780129901","0.0","0.18410097431355182","1.0","10","6","3","false","7485","20.0","3","3","false","0","7485","0"
"5.431801780129901","0.0","0.18410097431355182","1.0","10","6","3","false","9389","20.0","3","3","false","0","9389","0"
"5.628337743565071","1.2027456731378106","0.17767235115613111","0.0","10","6","3","false","9426","8.0","3","3","false","0","9426","105972994"
"5.629299975944191","0.0","0.17764198111191828","0.0","10","2","1","false","10246","22.0","1","1","false","0","10246","0"
"5.142891508299254","2.4177000444551755","0.1944431451424295","0.13333333333333333","10","12","6","false","11026","10.833333333333334","6","6","false","0","11026","209842659"
"5.550156362761607","0.0","0.1801751040221914","1.0","10","4","2","false","17953","13.0","2","2","false","0","17953","0"
"5.629299975944191","0.0","0.17764198111191828","0.0","10","2","1","false","18946","22.0","1","1","false","0","18946","0"
"5.52056771710368","1.1266171289199303","0.18114079044838557","0.3333333333333333","10","8","4","false","18983","8.25","4","4","false","0","18983","84972882"
"5.532114505653115","0.0","0.18076270817932774","1.0","10","4","2","false","19013","14.0","2","2","false","0","19013","0"
"5.306711570844359","0.9857340620128471","0.1884406165004533","0.16666666666666666","10","8","4","false","23458","10.25","4","4","false","0","23458","87679167"
"5.575174404618715","4.742080770750503","0.17936658612357612","0.2857142857142857","10","14","7","false","23986","6.285714285714286","7","7","false","0","23986","387690161"
"5.168631224440702","5.358099663875503","0.19347482081355302","0.2","11","10","5","false","4697","9.8","5","5","false","0","4697","411345337"
"6.167909550156363","0.0","0.16212948517940717","1.0","12","4","2","false","3007","4.0","2","2","false","0","3007","0"
"5.150829925426991","2.773412721220636","0.19414347095086867","0.4","11","10","5","false","22082","12.4","5","5","false","0","22082","219663231"
"6.167668992061583","1.1634472438038925","0.16213580872888958","0.3333333333333333","12","6","3","false","25537","2.6666666666666665","3","3","false","0","25537","93212932"
"4.9422660572528265","9.077904123646332","0.20233633487466537","0.15441176470588236","11","34","17","false","5695","8.529411764705882","17","17","false","0","5695","1074677532"
"5.257637719509262","0.0","0.19019948755490482","1.0","11","4","2","false","574","21.0","2","2","false","0","574","0"
"5.114505653115227","2.6025502787671506","0.19552231785899066","0.5","11","8","4","false","6971","16.5","4","4","false","0","6971","249673716"
"5.133509742602839","0.2303058333529795","0.19479850046860356","0.5","11","10","5","false","13282","15.2","5","5","false","0","13282","37614223"
"5.32475342795285","0.0","0.1878021233340863","1.0","11","4","2","false","15409","15.5","2","2","false","0","15409","0"
"5.199422660572528","0.0","0.192329045988711","1.0","11","6","3","false","18745","22.666666666666668","3","3","false","0","18745","0"
"5.226846283377435","0.0","0.1913199558173785","1.0","11","6","3","false","18758","17.333333333333332","3","3","false","0","18758","0"
"5.226846283377435","0.0","0.1913199558173785","1.0","11","6","3","false","21497","17.333333333333332","3","3","false","0","21497","0"
"4.546307433245128","19.90358231454095","0.21995872797502516","0.1286549707602339","9","38","19","false","22366","12.473684210526315","19","19","false","0","22366","2445103498"
"6.090930959826798","0.0","0.1641785150078989","1.0","11","4","2","false","23714","8.5","2","2","false","0","23714","0"
"6.680057733942747","0.0","0.1496993049803738","0.0","12","2","1","false","1153","13.0","1","1","false","0","1153","0"
"5.680298292037527","10.48952917404871","0.17604709270317198","0.07692307692307693","11","26","13","false","17501","3.076923076923077","13","13","false","0","17501","724787159"
"6.680057733942747","0.0","0.1496993049803738","0.0","12","2","1","false","4183","13.0","1","1","false","0","4183","0"
"6.679817175847967","0.0","0.14970469605301065","1.0","12","4","2","false","6010","8.5","2","2","false","0","6010","0"
"5.554967524657204","5.477284538531541","0.18001905421791098","0.23809523809523808","12","14","7","false","9862","6.714285714285714","7","7","false","0","9862","450084775"
"6.303584315612221","0.0","0.1586399023049916","1.0","12","6","3","false","12370","7.666666666666667","3","3","false","0","12370","0"
"6.679095501563627","2.255106071301975","0.14972087160093644","0.0","12","4","2","false","16834","7.5","2","2","false","0","16834","148943552"
"6.303584315612221","0.0","0.1586399023049916","1.0","12","6","3","false","16853","7.666666666666667","3","3","false","0","16853","0"
"5.318258359393794","5.825039692903468","0.18803148181653698","0.16666666666666666","11","8","4","false","16899","11.5","4","4","false","0","16899","376567530"
"6.679817175847967","0.0","0.14970469605301065","1.0","12","4","2","false","21199","8.5","2","2","false","0","21199","0"
"6.658888621602117","0.005720442764484042","0.1501752104331491","0.5","12","8","4","false","22299","5.0","4","4","false","0","22299","671532"
"6.501082511426509","0.13702658441386334","0.15382053654024053","0.3333333333333333","12","6","3","false","22309","6.666666666666667","3","3","false","0","22309","10071064"
"5.386576858311282","2.2610107710726934","0.18564665952125758","0.0","11","4","2","false","22620","22.0","2","2","false","0","22620","185052129"
"7.678373827279288","1.3784568649700413","0.13023590964629217","0.0","13","4","2","false","20248","1.5","2","2","false","0","20248","90941646"
"5.47750781813808","0.0","0.18256477821695213","1.0","11","4","2","false","12679","48.5","2","2","false","0","12679","0"
"5.298773153716622","1.8160175677341082","0.18872293094838155","0.5","10","8","4","false","573","11.25","4","4","false","0","573","118192181"
"5.541736829444311","0.0","0.1804488431653427","1.0","10","4","2","false","1430","13.0","2","2","false","0","1430","0"
"5.24055809477989","14.714464831566254","0.19081937112692218","0.1","10","32","16","false","2072","5.375","16","16","false","0","2072","1080482671"
"5.317777243204234","0.0","0.18804849362164117","1.0","10","6","3","false","4966","14.0","3","3","false","0","4966","0"
"5.072648544623527","0.12843431478237982","0.19713567600891543","0.7","10","10","5","false","19493","15.4","5","5","false","0","19493","21069692"
"5.786143853740678","0.13389337603700707","0.17282667442730637","0.6666666666666666","11","6","3","false","22278","10.666666666666666","3","3","false","0","22278","16109446"
"5.23983642049555","0.0","0.19084565237351941","1.0","11","4","2","false","5769","41.0","2","2","false","0","5769","0"
"6.329324031753669","0.0","0.15799475504541827","0.0","12","2","1","false","10896","7.0","1","1","false","0","10896","0"
"6.329324031753669","0.0","0.15799475504541827","0.0","12","2","1","false","20915","7.0","1","1","false","0","20915","0"
"6.327399566995429","2.6233249782421106","0.1580428088050793","0.0","12","4","2","false","22848","5.0","2","2","false","0","22848","283249217"
"5.929516478229492","0.0","0.1686478153271938","0.0","12","2","1","false","1347","15.0","1","1","false","0","1347","0"
"5.569882126533558","0.0","0.1795370130431027","1.0","11","14","7","false","4782","10.0","7","7","false","0","4782","0"
"5.569882126533558","0.0","0.1795370130431027","1.0","11","14","7","false","15582","10.0","7","7","false","0","15582","0"
"5.569882126533558","0.0","0.1795370130431027","1.0","11","14","7","false","17472","10.0","7","7","false","0","17472","0"
"5.569882126533558","0.0","0.1795370130431027","1.0","11","14","7","false","19707","10.0","7","7","false","0","19707","0"
"5.569882126533558","0.0","0.1795370130431027","1.0","11","14","7","false","21930","10.0","7","7","false","0","21930","0"
"5.551599711330287","0.5820946078825356","0.1801282606811682","0.75","11","16","8","false","24835","8.875","8","8","false","0","24835","53280586"
"5.929516478229492","0.0","0.1686478153271938","0.0","12","2","1","false","24959","15.0","1","1","false","0","24959","0"
"5.793841712773635","4.87514084408772","0.1725970521071206","0.19444444444444445","12","18","9","false","24009","4.111111111111111","9","9","false","0","24009","385236724"
"6.126774115949002","0.0","0.16321802976167105","1.0","12","4","2","false","283","9.0","2","2","false","0","283","0"
"6.793601154678855","0.0","0.14719733720477318","0.0","13","2","1","false","1880","9.0","1","1","false","0","1880","0"
"6.740678373827279","0.0","0.14835302094857428","1.0","13","6","3","false","5505","5.666666666666667","3","3","false","0","5505","0"
"5.139283136877556","7.624253926489353","0.19457966672907695","0.2222222222222222","11","18","9","false","15959","9.333333333333334","9","9","false","0","15959","697434281"
"6.793601154678855","0.0","0.14719733720477318","0.0","13","2","1","false","15961","9.0","1","1","false","0","15961","0"
"5.816694731777725","0.0","0.17191894127377996","1.0","12","6","3","false","24444","9.333333333333334","3","3","false","0","24444","0"
"7.1373586721193165","1.4879606625939865","0.14010785305021908","0.0","13","6","3","false","14316","4.666666666666667","3","3","false","0","14316","117807726"
"6.2792879480394515","5.540557998901999","0.15925372562540704","0.17857142857142858","12","16","8","false","14690","3.5","8","8","false","0","14690","448362303"
"8.137118114024537","0.0","0.12289363211730622","0.0","14","2","1","false","22254","3.0","1","1","false","0","22254","0"
"7.2790473899446715","0.0","0.13738061403218876","0.0","13","2","1","false","749","8.0","1","1","false","0","749","0"
"5.4469569401010345","5.7466364437639434","0.18358874707415096","0.4","11","10","5","false","1373","10.0","5","5","false","0","1373","466801213"
"7.278566273755112","0.9888501091541037","0.13738969494662392","0.0","13","4","2","false","3607","4.5","2","2","false","0","3607","80147094"
"5.80394515275439","2.833580724191519","0.17229659717329132","0.32142857142857145","12","16","8","false","7245","5.25","8","8","false","0","7245","221726156"
"6.294924224200145","0.05805995889672615","0.15885814735554876","0.8333333333333334","12","8","4","false","8031","6.25","4","4","false","0","8031","8161144"
"7.2790473899446715","0.0","0.13738061403218876","0.0","13","2","1","false","15907","8.0","1","1","false","0","15907","0"
"6.379841231657445","0.40361226649156884","0.15674371252969346","0.6666666666666666","12","8","4","false","19164","6.5","4","4","false","0","19164","38948714"
"5.679095501563627","0.0","0.1760843781768892","1.0","11","4","2","false","302","12.0","2","2","false","0","302","0"
"5.679817175847967","0.0","0.17606200499767058","1.0","11","4","2","false","2335","10.5","2","2","false","0","2335","0"
"5.680057733942747","0.0","0.1760545485346434","0.0","11","2","1","false","6702","19.0","1","1","false","0","6702","0"
"5.678373827279288","1.7141316651551715","0.17610675704299936","0.2","11","10","5","false","11490","5.2","5","5","false","0","11490","125496404"
"5.679817175847967","0.0","0.17606200499767058","1.0","11","4","2","false","16108","10.5","2","2","false","0","16108","0"
"5.680057733942747","0.0","0.1760545485346434","0.0","11","2","1","false","17174","19.0","1","1","false","0","17174","0"
"5.680057733942747","0.0","0.1760545485346434","0.0","11","2","1","false","17924","19.0","1","1","false","0","17924","0"
"5.600433004570604","0.0","0.17855762209527082","0.0","12","2","1","false","3999","21.0","1","1","false","0","3999","0"
"5.497233581910031","0.0","0.18190967967792754","1.0","12","4","2","false","8211","14.0","2","2","false","0","8211","0"
"5.165985085398123","0.0","0.19357392316647265","1.0","12","4","2","false","12373","21.5","2","2","false","0","12373","0"
"4.9961510704835215","5.596532097278198","0.20015407578602726","0.23809523809523808","11","14","7","false","20059","14.428571428571429","7","7","false","0","20059","449687486"
"4.849410632667789","11.809982368839913","0.20621062552705988","0.28888888888888886","11","20","10","false","2155","11.6","10","10","false","0","2155","1607564259"
"5.189319220591773","0.0","0.19270350454292604","1.0","11","6","3","false","4283","20.333333333333332","3","3","false","0","4283","0"
"4.893673322107289","5.420044965169354","0.20434547510200068","0.21212121212121213","11","24","12","false","6408","9.75","12","12","false","0","6408","656138684"
"5.32667789271109","0.0","0.1877342726821117","1.0","11","4","2","false","7715","18.0","2","2","false","0","7715","0"
"5.424344479191725","0.0","0.18435407335136814","0.0","11","2","1","false","8920","28.0","1","1","false","0","8920","0"
"5.155641087322588","0.4320606576330918","0.19396229936543485","0.5","11","10","5","false","23256","15.6","5","5","false","0","23256","75637661"
"6.200384892951647","0.43964654539709913","0.16128031037827353","0.4","12","22","11","false","2607","6.454545454545454","11","11","false","0","2607","77098837"
"6.549434688477267","0.0","0.15268493351942997","1.0","12","4","2","false","3450","15.5","2","2","false","0","3450","0"
"5.627616069280731","2.337784287680138","0.1776951355048303","0.4666666666666667","12","12","6","false","4588","11.833333333333334","6","6","false","0","4588","259114139"
"6.542217945633871","0.0","0.1528533607883512","1.0","12","8","4","false","5130","12.0","4","4","false","0","5130","0"
"6.548953572287708","0.0","0.15269615045548046","1.0","12","8","4","false","5353","11.25","4","4","false","0","5353","0"
"5.649266297810922","2.734031191097573","0.17701413728495996","0.26666666666666666","11","12","6","false","5835","8.333333333333334","6","6","false","0","5835","231143072"
"6.200625451046427","0.35521779657691127","0.16127405338299194","0.4666666666666667","12","20","10","false","9450","7.0","10","10","false","0","9450","65560750"
"6.268943949963917","0.0","0.15951650038372986","1.0","12","8","4","false","12165","11.75","4","4","false","0","12165","0"
"6.508780370459466","1.4390228361814081","0.15363861477621318","0.42857142857142855","12","14","7","false","12722","8.285714285714286","7","7","false","0","12722","135671551"
"6.334616309838826","0.0","0.1578627577564273","1.0","12","8","4","false","20003","11.75","4","4","false","0","20003","0"
"6.548953572287708","0.0","0.15269615045548046","1.0","12","8","4","false","20184","11.25","4","4","false","0","20184","0"
"1.0","2.0","1.0","0.0","1","6","3","false","24640","1.0","3","3","false","0","24640","12"
"1.6666666666666667","0.0","0.6","0.0","2","4","2","false","4685","3.0","2","1","false","1","4685","0"
"1.6666666666666667","0.0","0.6","0.0","2","2","1","false","15415","3.0","1","1","false","0","15415","0"
"1.6666666666666667","0.0","0.6","0.0","2","2","1","false","24152","3.0","1","1","false","0","24152","0"
"6.208323310079384","0.0","0.1610740855548667","1.0","11","6","3","false","8376","8.666666666666666","3","3","false","0","8376","0"
"5.5268222275679575","0.0","0.18093579978237215","1.0","11","6","3","false","8888","14.333333333333334","3","3","false","0","8888","0"
"5.476786143853741","0.6479714175114895","0.1825888347169148","0.4666666666666667","11","12","6","false","13067","9.166666666666666","6","6","false","0","13067","67380983"
"6.432042338224681","1.3029604042302105","0.15547161343406388","0.3333333333333333","12","6","3","false","4213","7.666666666666667","3","3","false","0","4213","105406538"
"6.076978590329564","5.963938351706267","0.16455545879186131","0.37777777777777777","12","20","10","false","7045","7.0","10","10","false","0","7045","580742839"
"6.433245128698581","0.0","0.1554425457128968","0.0","12","2","1","false","11892","19.0","1","1","false","0","11892","0"
"6.432523454414241","0.0","0.15545998504113687","1.0","12","4","2","false","20645","11.0","2","2","false","0","20645","0"
"6.433245128698581","0.0","0.1554425457128968","0.0","12","2","1","false","23264","19.0","1","1","false","0","23264","0"
"6.989415443829685","2.950722577245427","0.14307348132851488","0.26666666666666666","13","12","6","false","10600","4.333333333333333","6","6","false","0","10600","458385632"
"6.990137118114024","0.0","0.14305871016587515","1.0","13","6","3","false","13493","8.0","3","3","false","0","13493","0"
"6.991099350493144","0.0","0.143039020026151","1.0","13","4","2","false","13496","9.0","2","2","false","0","13496","0"
"5.693288429155641","0.7907275108366008","0.17564541344488108","0.5","12","8","4","false","18788","16.75","4","4","false","0","18788","165438835"
"6.991099350493144","0.0","0.143039020026151","1.0","13","4","2","false","18791","9.0","2","2","false","0","18791","0"
"6.989415443829685","0.9840900571713285","0.14307348132851488","0.3333333333333333","13","12","6","false","23394","4.333333333333333","6","6","false","0","23394","152702605"
"6.232619677652153","1.45299308248303","0.16044617700412986","0.4","11","12","6","false","140","4.333333333333333","6","6","false","0","140","101381531"
"6.403415924945874","0.0","0.15616664788309104","1.0","11","8","4","false","17304","5.75","4","4","false","0","17304","0"
"6.403415924945874","0.0","0.15616664788309104","1.0","11","8","4","false","18587","5.75","4","4","false","0","18587","0"
"6.134953091171518","0.8724982149106182","0.16300043132180528","0.4666666666666667","11","12","6","false","19404","5.666666666666667","6","6","false","0","19404","57387739"
"6.300938176569642","0.7897126358226607","0.15870652464398885","0.5","12","8","4","false","22462","7.25","4","4","false","0","22462","52714523"
"7.232379119557373","0.0","0.1382670879760519","0.0","12","2","1","false","24122","6.0","1","1","false","0","24122","0"
"5.622804907385134","0.374500183935324","0.17784718062804825","0.7","12","10","5","false","1078","6.4","5","5","false","0","1078","91846548"
"5.740437815732499","0.0","0.17420274064451244","1.0","12","8","4","false","5164","7.25","4","4","false","0","5164","0"
"5.743324512869858","0.0","0.1741151832460733","0.0","12","2","1","false","9387","14.0","1","1","false","0","9387","0"
"5.65263411113784","0.38395766091482353","0.17690867307855987","0.0","12","4","2","false","11640","10.0","2","2","false","0","11640","37811065"
"4.264613904257878","47.04784199691653","0.23448781588447654","0.09090909090909091","10","44","22","false","12545","13.227272727272727","22","22","false","0","12545","4942422123"
"5.175366851094539","1.3198819013789436","0.19322301756995444","0.3333333333333333","11","8","4","false","13371","13.75","4","4","false","0","13371","225964749"
"5.7382727928794806","5.1785659959209305","0.17426846650456945","0.7","12","10","5","false","17116","6.4","5","5","false","0","17116","999267452"
"5.7382727928794806","5.1785659959209305","0.17426846650456945","0.7","12","10","5","false","19741","6.4","5","5","false","0","19741","999267452"
"5.743324512869858","0.0","0.1741151832460733","0.0","12","2","1","false","22149","14.0","1","1","false","0","22149","0"
"5.518883810440221","0.3824077799483297","0.18119605962862873","0.3333333333333333","12","6","3","false","16331","6.666666666666667","3","3","false","0","16331","24867922"
"5.7296127014674045","0.0","0.17453186665547066","1.0","12","4","2","false","19184","9.0","2","2","false","0","19184","0"
"5.364204955496753","0.11201077652585507","0.18642091573613165","0.5","10","10","5","false","17843","11.2","5","5","false","0","17843","13406211"
"5.178734664421458","4.1010069865091365","0.19309736157562243","0.16666666666666666","10","18","9","false","1685","7.777777777777778","9","9","false","0","1685","324545521"
"5.41255713254751","1.5631402919369826","0.18475555555555556","0.4","11","12","6","false","8134","9.333333333333334","6","6","false","0","8134","174682615"
"4.904979552561944","12.773017148343577","0.20387444825895046","0.21818181818181817","11","22","11","false","12687","10.363636363636363","11","11","false","0","12687","1072264197"
"5.444791917248016","0.0","0.18366174781302463","1.0","11","4","2","false","23409","16.5","2","2","false","0","23409","0"
"5.069280731296608","0.9674192969305897","0.19726664452142553","0.3333333333333333","10","8","4","false","1321","17.25","4","4","false","0","1321","111245337"
"5.443829684868896","0.0","0.1836942112240389","1.0","11","4","2","false","4433","17.0","2","2","false","0","4433","0"
"5.203993264373346","0.6051658988487464","0.19216012573383257","0.3333333333333333","11","6","3","false","5125","14.333333333333334","3","3","false","0","5125","49556765"
"5.39138802020688","1.3110780170554936","0.18548099232553988","0.2","10","12","6","false","7625","8.0","6","6","false","0","7625","130558420"
"5.009862881885976","5.03625216703222","0.1996062614040142","0.25","10","16","8","false","10895","10.625","8","8","false","0","10895","371314673"
"5.445032475342796","0.0","0.1836536337530373","0.0","11","2","1","false","11899","28.0","1","1","false","0","11899","0"
"5.078662496993024","3.552527545868023","0.19690223569533913","0.3333333333333333","11","8","4","false","13711","15.25","4","4","false","0","13711","217276439"
"5.188838104402213","8.598921426041246","0.1927213722763097","0.4","11","12","6","false","16162","12.666666666666666","6","6","false","0","16162","677959540"
"5.329083473658889","0.0","0.18764952828059406","1.0","11","4","2","false","16475","16.0","2","2","false","0","16475","0"
"5.445032475342796","0.0","0.1836536337530373","0.0","11","2","1","false","19167","28.0","1","1","false","0","19167","0"
"4.728891027183065","1.2469148250698117","0.2114660697934683","0.5","10","8","4","false","19387","35.0","4","4","false","0","19387","88810887"
"5.051238874188116","6.053382218687815","0.19797123535574818","0.12727272727272726","10","22","11","false","21089","7.363636363636363","11","11","false","0","21089","477400232"
"5.398604763050277","0.0","0.18523304518313874","1.0","11","4","2","false","21727","15.5","2","2","false","0","21727","0"
"5.367332210728891","0.34349749841001387","0.18631229831480817","0.0","11","4","2","false","23863","16.0","2","2","false","0","23863","33724378"
"5.014433485686793","1.7875590600897227","0.1994243223794675","0.3333333333333333","10","8","4","false","25565","12.75","4","4","false","0","25565","167398503"
"7.062785662737551","0.0","0.14158719346049048","0.0","12","2","1","false","5060","4.0","1","1","false","0","5060","0"
"6.063026220832331","2.037818788383007","0.16493413743850183","0.0","11","8","4","false","20660","4.5","4","4","false","0","20660","123977314"
"5.8272792879480395","0.8508301167412431","0.1716066710700132","0.0","11","4","2","false","1608","18.0","2","2","false","0","1608","49919275"
"6.403656483040654","1.6185135184126787","0.15616078136739295","0.47619047619047616","12","14","7","false","20030","5.428571428571429","7","7","false","0","20030","100007331"
"5.579985566514313","2.17382968509193","0.17921193309191238","0.5","11","8","4","false","11447","6.0","4","4","false","0","11447","192977541"
"6.492903536203993","0.0","0.1540143010633174","1.0","12","6","3","false","834","4.0","3","3","false","0","834","0"
"6.240798652874669","0.7400246365828438","0.1602359017846818","0.3","12","10","5","false","2490","4.0","5","5","false","0","2490","47587994"
"6.492903536203993","0.0","0.1540143010633174","1.0","12","6","3","false","5570","4.0","3","3","false","0","5570","0"
"5.6235265816694735","0.0","0.1778243572742439","0.0","12","2","1","false","15625","13.0","1","1","false","0","15625","0"
"5.016117392350252","0.1911905991184509","0.199357375791291","0.6666666666666666","11","8","4","false","15917","21.75","4","4","false","0","15917","53643507"
"4.661775318739475","26.207113600169176","0.214510552660096","0.10989010989010989","10","28","14","false","18140","12.285714285714286","14","14","false","0","18140","2382494322"
"5.263411113783979","0.0","0.18999085923217549","1.0","11","4","2","false","18790","23.0","2","2","false","0","18790","0"
"5.038729853259563","2.8477984100480134","0.19846271364460993","0.19047619047619047","11","14","7","false","24110","12.571428571428571","7","7","false","0","24110","308268834"
"4.775318739475583","1.1926103423012087","0.20941010528436854","0.3333333333333333","10","12","6","false","4466","14.333333333333334","6","6","false","0","4466","167845120"
"5.166225643492903","0.0","0.19356490966660458","1.0","12","4","2","false","8505","31.5","2","2","false","0","8505","0"
"5.144815973057494","1.0232181529491169","0.19437041193248233","0.5111111111111111","12","20","10","false","16357","12.8","10","10","false","0","16357","175880596"
"4.833774356507097","3.4433403049157962","0.20687767492783915","0.3333333333333333","11","14","7","false","20116","35.57142857142857","7","7","false","0","20116","776057882"
"4.719990377676209","13.358835961360917","0.21186483869323686","0.13636363636363635","11","24","12","false","20148","15.25","12","12","false","0","20148","1491994960"
"5.099350493144095","0.29157088063563924","0.19610340598169637","0.6","12","10","5","false","22899","18.8","5","5","false","0","22899","57512471"
"5.4996391628578305","0.8177680877787995","0.18183011110139094","0.3333333333333333","12","6","3","false","25710","12.666666666666666","3","3","false","0","25710","95859850"
"4.845802261246091","4.212299743642972","0.2063641779189833","0.2692307692307692","11","26","13","false","4068","17.615384615384617","13","13","false","0","4068","654968984"
"5.36877555929757","0.0","0.18626220987543687","1.0","12","4","2","false","9517","23.5","2","2","false","0","9517","0"
"5.174885734904979","25.35746503683732","0.1932409817776125","0.1111111111111111","12","36","18","false","11400","8.5","18","18","false","0","11400","2686895378"
"5.3584315612220355","0.0","0.18662177328843996","1.0","12","10","5","false","11630","17.4","5","5","false","0","11630","0"
"5.36901611739235","0.0","0.18625386442044894","0.0","12","2","1","false","11700","45.0","1","1","false","0","11700","0"
"5.158527784459947","3.2629664733677766","0.1938537586271218","0.1794871794871795","12","26","13","false","11733","9.384615384615385","13","13","false","0","11733","344661654"
"5.356747654558576","0.3795047425286027","0.18668043829710795","0.6666666666666666","12","6","3","false","11951","21.666666666666668","3","3","false","0","11951","66470911"
"5.3502525859995185","6.100744085663489E-4","0.18690706353131606","0.9047619047619048","12","14","7","false","12268","14.857142857142858","7","7","false","0","12268","116109"
"5.362761606928073","3.600597747737548","0.1864710895796887","0.4","12","10","5","false","14093","14.4","5","5","false","0","14093","420784799"
"5.223237911955738","0.0","0.19145212545479665","1.0","11","4","2","false","15685","28.5","2","2","false","0","15685","0"
"5.203031031994227","5.025501982568131","0.19219566322992276","0.2647058823529412","12","34","17","false","16006","10.411764705882353","17","17","false","0","16006","689915666"
"5.253307673803223","0.2126117968237283","0.19035625973074458","0.4666666666666667","12","12","6","false","16495","16.166666666666668","6","6","false","0","16495","35781171"
"5.36877555929757","0.0","0.18626220987543687","1.0","12","4","2","false","17135","25.0","2","2","false","0","17135","0"
"5.36877555929757","0.0","0.18626220987543687","1.0","12","4","2","false","20169","23.5","2","2","false","0","20169","0"
"5.350012027904739","0.0037870402285168385","0.18691546762589928","0.7142857142857143","12","16","8","false","22188","13.125","8","8","false","0","22188","371205"
"5.36877555929757","0.0","0.18626220987543687","1.0","12","4","2","false","22189","24.0","2","2","false","0","22189","0"
"5.341111378397883","0.0","0.18722695131288564","1.0","12","6","3","false","22621","21.333333333333332","3","3","false","0","22621","0"
"5.36877555929757","0.0","0.18626220987543687","1.0","12","4","2","false","22811","26.5","2","2","false","0","22811","0"
"5.250420976665865","0.0968512060015635","0.19046091817098873","0.6","11","10","5","false","22975","17.0","5","5","false","0","22975","14548406"
"5.323550637478951","0.03092988705969211","0.1878445549028468","0.6785714285714286","12","16","8","false","23110","14.0","8","8","false","0","23110","4398292"
"5.251383209044985","0.02529194460853853","0.19042601923957855","0.6666666666666666","12","6","3","false","23509","18.0","3","3","false","0","23509","6290035"
"5.046668270387299","1.7583928913652056","0.1981505314838648","0.2087912087912088","11","28","14","false","23552","10.357142857142858","14","14","false","0","23552","260653371"
"4.744286745248978","9.423982985093552","0.2107798397728425","0.18181818181818182","10","24","12","false","23805","12.916666666666666","12","12","false","0","23805","1000208350"
"5.227086841472215","0.0","0.1913111509963643","1.0","11","6","3","false","23806","26.333333333333332","3","3","false","0","23806","0"
"5.365167187875872","1.204419450430099","0.1863874815047303","0.4","12","10","5","false","25557","13.8","5","5","false","0","25557","116310332"
"5.220110656723599","0.03862322996384309","0.19156682027649768","0.6","11","10","5","false","25562","15.6","5","5","false","0","25562","5247562"
"4.825114265095021","5.108399478776364","0.20724897796390465","0.2","9","12","6","false","7801","12.666666666666666","6","6","false","0","7801","457440562"
"5.427471734423864","4.598761419606552","0.18424785036787517","0.3","10","10","5","false","14089","8.4","5","5","false","0","14089","352501283"
"5.299494828000962","3.374608895291393","0.18869723104857014","0.1","10","10","5","false","14967","7.6","5","5","false","0","14967","237489716"
"5.237671397642531","3.1964863584574923","0.19092453956735406","0.2","10","10","5","false","25215","8.0","5","5","false","0","25215","261380608"
"5.054366129420255","0.5065730441429921","0.1978487458950074","0.3333333333333333","10","6","3","false","11868","24.666666666666668","3","3","false","0","11868","67232735"
"5.061582872263652","1.4149943736305233","0.1975666555772064","0.4166666666666667","10","18","9","false","24023","29.11111111111111","9","9","false","0","24023","303975355"
"6.637478951166707","0.0","0.15065961148158885","1.0","12","6","3","false","2559","6.666666666666667","3","3","false","0","2559","0"
"6.637478951166707","0.0","0.15065961148158885","1.0","12","6","3","false","5543","6.666666666666667","3","3","false","0","5543","0"
"6.046427712292519","1.9983424272582162","0.16538691068231548","0.5","12","8","4","false","5767","9.25","4","4","false","0","5767","266113663"
"5.795525619437094","7.863394831364937","0.17254690353644364","0.3333333333333333","12","20","10","false","10931","10.0","10","10","false","0","10931","999646383"
"6.633630021650228","13.403509057278525","0.15074702639976792","0.1111111111111111","12","20","10","false","24097","2.9","10","10","false","0","24097","1233337643"
"5.273995669954294","12.650028776748075","0.18960956029921547","0.15151515151515152","10","24","12","false","14952","5.666666666666667","12","12","false","0","14952","1048294433"
"5.645417368294443","0.01474837236941131","0.17713482188512017","0.6666666666666666","10","6","3","false","16953","11.333333333333334","3","3","false","0","16953","2838745"
"5.530430598989656","0.038299729098958145","0.180817746846455","0.6666666666666666","11","6","3","false","20191","10.0","3","3","false","0","20191","5763437"
"5.786865528025018","0.7036313274708778","0.17280512138343865","0.0","11","4","2","false","25934","6.5","2","2","false","0","25934","63697755"
"7.215780611017561","1.602019032567491","0.13858514468595812","0.3333333333333333","12","6","3","false","10467","2.6666666666666665","3","3","false","0","10467","129517002"
"8.215299494828","0.0","0.1217241076396006","1.0","13","4","2","false","13175","2.5","2","2","false","0","13175","0"
"6.2169834014914604","3.350154186393858","0.16084971366661507","0.16666666666666666","11","8","4","false","20892","4.75","4","4","false","0","20892","270594457"
"8.215299494828","0.0","0.1217241076396006","1.0","13","4","2","false","21816","2.5","2","2","false","0","21816","0"
"5.795285061342314","0.7826341438208926","0.17255406583371383","0.2","12","12","6","false","25209","3.8333333333333335","6","6","false","0","25209","64449204"
"6.861679095501564","0.0","0.14573692329266583","0.0","13","2","1","false","14371","6.0","1","1","false","0","14371","0"
"5.861919653596344","1.2890963449600208","0.1705925804333552","0.4","12","12","6","false","17443","4.333333333333333","6","6","false","0","17443","85210777"
"5.875150348809237","0.0","0.1702084101052287","1.0","12","8","4","false","141","6.25","4","4","false","0","141","0"
"5.438777964878518","1.0633739038410073","0.18386483258879208","0.35714285714285715","12","16","8","false","8408","6.25","8","8","false","0","8408","76543838"
"5.875150348809237","0.0","0.1702084101052287","1.0","12","8","4","false","17286","6.25","4","4","false","0","17286","0"
"6.485205677171037","0.09873043915793105","0.154197114136281","0.0","13","4","2","false","25827","6.0","2","2","false","0","25827","6543339"
"5.175607409189319","1.1786685006678397","0.19321403671856843","0.3333333333333333","10","6","3","false","5246","12.666666666666666","3","3","false","0","5246","91265492"
"5.495549675246572","0.0","0.18196541912891223","1.0","11","4","2","false","10524","10.5","2","2","false","0","10524","0"
"5.428193408708203","0.0","0.18422335475293597","1.0","10","4","2","false","12337","10.0","2","2","false","0","12337","0"
"5.496030791436132","0.0","0.18194949008622577","0.0","11","2","1","false","15419","17.0","1","1","false","0","15419","0"
"6.735145537647342","1.3669324189193037","0.1484748910636474","0.5","12","8","4","false","24","4.25","4","4","false","0","24","140566586"
"6.733702189078662","2.9637138141238393","0.1485067162046299","0.6666666666666666","12","8","4","false","3858","5.25","4","4","false","0","3858","698160564"
"5.460668751503488","10.854650182697574","0.18312775330396477","0.19047619047619047","11","42","21","false","15066","7.9523809523809526","21","21","false","0","15066","1229107076"
"6.733702189078662","2.9637138141238393","0.1485067162046299","0.6666666666666666","12","8","4","false","23161","5.25","4","4","false","0","23161","698160564"
"5.164782294924224","13.413766870745302","0.1936190032603633","0.21818181818181817","10","22","11","false","25378","10.545454545454545","11","11","false","0","25378","2267509781"
"5.1816213615588165","3.6591155669040334","0.19298978644382545","0.4","11","12","6","false","205","10.833333333333334","6","6","false","0","205","317128557"
"5.3762328602357465","0.0","0.1860038480468925","1.0","11","4","2","false","12389","11.5","2","2","false","0","12389","0"
"5.441905220110657","0.0","0.18375917248695958","0.0","11","2","1","false","15718","16.0","1","1","false","0","15718","0"
"5.347125330767381","0.0","0.18701637574230698","1.0","11","6","3","false","16506","11.333333333333334","3","3","false","0","16506","0"
"5.150108251142651","4.6328455785759335","0.19417067588397402","0.19047619047619047","10","14","7","false","21650","7.0","7","7","false","0","21650","339647218"
"5.380803464036565","0.7053181282403858","0.18584585121602287","0.3333333333333333","11","6","3","false","22502","9.333333333333334","3","3","false","0","22502","59909172"
"5.687515034880923","10.099830757801817","0.17582371103497865","0.14102564102564102","12","26","13","false","482","7.076923076923077","13","13","false","0","482","989915842"
"5.968005773394275","0.0","0.16756015961949292","1.0","12","6","3","false","3411","19.0","3","3","false","0","3411","0"
"5.968005773394275","0.0","0.16756015961949292","1.0","12","6","3","false","4428","19.0","3","3","false","0","4428","0"
"5.860957421217224","0.7869107390015289","0.17062058775242162","0.5714285714285714","12","16","8","false","5392","11.25","8","8","false","0","5392","141668462"
"5.967765215299495","0.0","0.16756691389874234","1.0","12","8","4","false","6317","15.25","4","4","false","0","6317","0"
"5.860957421217224","0.7869107390015289","0.17062058775242162","0.5714285714285714","12","16","8","false","7541","11.25","8","8","false","0","7541","141668462"
"5.967765215299495","0.0","0.16756691389874234","1.0","12","8","4","false","15664","15.25","4","4","false","0","15664","0"
"5.6324272311763295","4.943711905115261","0.1775433501323994","0.19298245614035087","11","38","19","false","16469","6.7894736842105265","19","19","false","0","16469","609749499"
"5.861438537406784","0.4637237427674641","0.1706065829434458","0.6666666666666666","12","14","7","false","17665","12.142857142857142","7","7","false","0","17665","79538213"
"5.905941784941064","0.0","0.16932100525436844","1.0","12","8","4","false","20424","17.5","4","4","false","0","20424","0"
"5.968005773394275","0.0","0.16756015961949292","1.0","12","6","3","false","24734","19.0","3","3","false","0","24734","0"
"6.460428193408708","0.0","0.1547885016383676","0.0","12","2","1","false","8206","21.0","1","1","false","0","8206","0"
"6.460428193408708","0.0","0.1547885016383676","0.0","12","2","1","false","12865","21.0","1","1","false","0","12865","0"
"5.431080105845561","11.752922752693118","0.18412543739203616","0.25","11","32","16","false","13384","10.4375","16","16","false","0","13384","1145670609"
"6.2528265576136635","0.17672146673393607","0.15992767283499404","0.7","12","10","5","false","17688","10.2","5","5","false","0","17688","32988598"
"6.63194611498677","0.0","0.15078530233232978","1.0","12","4","2","false","3826","10.5","2","2","false","0","3826","0"
"6.63194611498677","0.0","0.15078530233232978","1.0","12","4","2","false","12369","10.5","2","2","false","0","12369","0"
"6.6321866730815495","0.0","0.15077983315197677","0.0","12","2","1","false","13498","19.0","1","1","false","0","13498","0"
"6.63194611498677","0.0","0.15078530233232978","1.0","12","4","2","false","19111","10.5","2","2","false","0","19111","0"
"6.63194611498677","0.0","0.15078530233232978","1.0","12","4","2","false","22239","10.5","2","2","false","0","22239","0"
"5.597546307433245","6.207834784978339","0.1786497056169152","0.2","12","10","5","false","19084","5.4","5","5","false","0","19084","380447599"
"5.505412557132548","0.0","0.18163943021934806","1.0","12","8","4","false","23943","11.0","4","4","false","0","23943","0"
"6.347125330767381","0.0","0.15755163918893308","0.0","13","2","1","false","75","6.0","1","1","false","0","75","0"
"5.751984604281934","0.7228461911123507","0.17385303835054997","0.3333333333333333","11","8","4","false","8807","5.75","4","4","false","0","8807","58270909"
"6.19533317296127","0.0","0.16141181952318087","1.0","12","4","2","false","22530","4.0","2","2","false","0","22530","0"
"6.52080827519846","1.5492791013360814","0.15335522189840264","0.16666666666666666","12","8","4","false","15353","2.5","4","4","false","0","15353","101250104"
"6.52128939138802","0.0","0.15334390792725663","1.0","12","4","2","false","3449","5.0","2","2","false","0","3449","0"
"7.52056771710368","0.0","0.13296868502702877","0.0","13","2","1","false","17950","4.0","1","1","false","0","17950","0"
"7.52056771710368","0.0","0.13296868502702877","0.0","13","2","1","false","18522","4.0","1","1","false","0","18522","0"
"1.5","0.0","0.6666666666666666","0.0","2","2","1","false","6709","2.0","1","1","false","0","6709","0"
"1.0","2.0","1.0","0.0","1","4","2","false","18003","1.0","2","2","false","0","18003","4"
"1.5","0.0","0.6666666666666666","0.0","2","2","1","false","5545","2.0","1","1","false","0","5545","0"
"5.452970892470532","4.990574591184368","0.18338627139580024","0.26666666666666666","11","12","6","false","12135","7.5","6","6","false","0","12135","446034412"
"6.451768101996632","0.0","0.15499627143922445","1.0","12","6","3","false","2475","4.666666666666667","3","3","false","0","2475","0"
"6.452489776280972","0.0","0.15497893598777168","1.0","12","4","2","false","3209","4.0","2","2","false","0","3209","0"
"6.452489776280972","0.0","0.15497893598777168","1.0","12","4","2","false","15973","4.0","2","2","false","0","15973","0"
"6.451768101996632","0.0","0.15499627143922445","1.0","12","6","3","false","21928","4.666666666666667","3","3","false","0","21928","0"
"6.451286985807072","1.1275143703941748","0.15500783056156314","0.4","12","10","5","false","24765","3.2","5","5","false","0","24765","101184300"
"5.401010343998076","0.0","0.18515054338143594","1.0","11","6","3","false","6219","11.0","3","3","false","0","6219","0"
"5.401010343998076","0.0","0.18515054338143594","1.0","11","6","3","false","18160","11.0","3","3","false","0","18160","0"
"9.25980274236228","0.0","0.10799366118515054","1.0","16","4","2","false","1833","4.5","2","2","false","0","1833","0"
"8.26028385855184","5.52074009005995","0.12106121498048808","0.09523809523809523","15","14","7","false","8177","2.142857142857143","7","7","false","0","8177","505610218"
"9.25980274236228","0.0","0.10799366118515054","1.0","16","4","2","false","12107","4.5","2","2","false","0","12107","0"
"9.2595621842675","0.9227355298749306","0.10799646679829576","0.0","16","4","2","false","4819","4.0","2","2","false","0","4819","84297749"
"9.25980274236228","0.0","0.10799366118515054","1.0","16","4","2","false","7863","4.5","2","2","false","0","7863","0"
"9.25980274236228","0.0","0.10799366118515054","1.0","16","4","2","false","8596","4.5","2","2","false","0","8596","0"
"7.263892229973538","8.669212187288947","0.1376672406941317","0.0","14","8","4","false","13635","3.5","4","4","false","0","13635","794435138"
"9.26004330045706","0.0","0.10799085571777421","0.0","16","2","1","false","17848","7.0","1","1","false","0","17848","0"
"6.298773153716622","0.5814663069331436","0.1587610754659334","0.0","11","4","2","false","25152","3.0","2","2","false","0","25152","34805349"
"5.952610055328361","1.3587681457555156","0.1679935340472823","0.3333333333333333","11","8","4","false","25408","4.0","4","4","false","0","25408","99851145"
"6.219148424344479","2.9840041601037988","0.16079371833056125","0.16666666666666666","11","8","4","false","11891","3.25","4","4","false","0","11891","243862268"
"6.219148424344479","1.1071114436889156","0.16079371833056125","0.16666666666666666","11","8","4","false","20243","3.25","4","4","false","0","20243","90856864"
"5.7474140004811165","6.317833504625823E-5","0.17399129415704","0.6666666666666666","11","6","3","false","19233","6.666666666666667","3","3","false","0","19233","2183"
"5.7476545585758965","0.0","0.1739840120537396","1.0","11","4","2","false","733","9.5","2","2","false","0","733","0"
"5.7476545585758965","0.0","0.1739840120537396","1.0","11","4","2","false","20597","9.5","2","2","false","0","20597","0"
"5.7478951166706755","0.0","0.17397673055997323","0.0","11","2","1","false","3171","16.0","1","1","false","0","3171","0"
"5.7478951166706755","0.0","0.17397673055997323","0.0","11","2","1","false","19149","16.0","1","1","false","0","19149","0"
"5.328842915564109","6.3582043059581865","0.1876579992777176","0.16363636363636364","11","22","11","false","19340","7.0","11","11","false","0","19340","562751708"
"5.742362280490738","4.408506397016246","0.17414435926437938","0.5","11","8","4","false","7824","7.25","4","4","false","0","7824","441005655"
"5.744046187154198","0.6495287932295515","0.17409330764720662","0.0","11","4","2","false","8815","10.0","2","2","false","0","8815","56143816"
"5.743083954775078","0.6295280315008394","0.17412247633408728","0.6666666666666666","11","6","3","false","12065","8.666666666666666","3","3","false","0","12065","110216289"
"5.4642771229251865","0.0","0.1830068236847898","1.0","11","4","2","false","14558","16.5","2","2","false","0","14558","0"
"5.744527303343758","0.0","0.1740787269681742","0.0","11","2","1","false","15306","19.0","1","1","false","0","15306","0"
"5.744527303343758","0.0","0.1740787269681742","0.0","11","2","1","false","15400","19.0","1","1","false","0","15400","0"
"5.690882848207842","0.0","0.17571966014287527","1.0","11","4","2","false","22528","13.0","2","2","false","0","22528","0"
"5.690882848207842","0.0","0.17571966014287527","1.0","11","4","2","false","22832","13.0","2","2","false","0","22832","0"
"5.723358191003127","0.0","0.17472259583053126","1.0","11","4","2","false","10969","11.5","2","2","false","0","10969","0"
"5.726004330045706","0.0","0.17464185186741168","0.0","11","2","1","false","13321","18.0","1","1","false","0","13321","0"
"5.726004330045706","0.0","0.17464185186741168","0.0","11","2","1","false","16958","18.0","1","1","false","0","16958","0"
"5.5617031513110415","0.6299513872593222","0.17980103806228373","0.4","11","10","5","false","19109","8.0","5","5","false","0","19109","54648421"
"5.726004330045706","0.0","0.17464185186741168","0.0","11","2","1","false","23346","18.0","1","1","false","0","23346","0"
"5.425306711570844","0.0","0.18432137631357248","1.0","10","4","2","false","2848","14.0","2","2","false","0","2848","0"
"4.936011546788549","13.119395518062243","0.2025927189434183","0.022222222222222223","10","20","10","false","4896","8.5","10","10","false","0","4896","1148529410"
"5.1190762569160455","14.886634664210353","0.19534774436090224","0.1111111111111111","10","18","9","false","8666","7.333333333333333","9","9","false","0","8666","1147068525"
"5.6237671397642535","0.0","0.17781675079134227","0.0","10","2","1","false","10552","19.0","1","1","false","0","10552","0"
"5.126052441664662","3.8213207372763924","0.1950818902811019","0.25","10","18","9","false","12884","11.11111111111111","9","9","false","0","12884","468774900"
"4.887899927832572","4.527859501443798","0.20458683990353857","0.2777777777777778","10","18","9","false","18511","12.333333333333334","9","9","false","0","18511","633722608"
"5.445994707721915","0.0","0.18362118468130217","1.0","10","4","2","false","25988","12.5","2","2","false","0","25988","0"
"5.86937695453452","0.0","0.170375835075208","0.0","11","2","1","false","22371","5.0","1","1","false","0","22371","0"
"1.0","0.0","1.0","1.0","1","4","2","false","11566","2.0","2","2","false","0","11566","0"
"1.0","0.0","1.0","1.0","1","4","2","false","11808","2.0","2","2","false","0","11808","0"
"1.0","0.0","1.0","1.0","1","4","2","false","18560","2.0","2","2","false","0","18560","0"
"1.0","0.0","1.0","0.0","1","2","1","false","15249","1.0","1","1","false","0","15249","0"
"1.0","0.0","1.0","0.0","1","2","1","false","15624","1.0","1","1","false","0","15624","0"
"4.901852297329805","3.3360261761243604","0.2040045148942435","0.5555555555555556","11","18","9","false","1058","16.11111111111111","9","9","false","0","1058","691868548"
"5.54366129420255","0.0","0.1803862009112606","1.0","12","4","2","false","2614","14.0","2","2","false","0","2614","0"
"5.15275439018523","0.16948955929957507","0.19407096171802055","0.6666666666666666","11","6","3","false","3730","18.333333333333332","3","3","false","0","3730","21038181"
"5.576377195092615","1.192689002844592","0.17932789784737502","0.3333333333333333","12","6","3","false","7449","8.0","3","3","false","0","7449","109195780"
"5.296127014674044","5.8472050995519504","0.1888172238372093","0.09090909090909091","12","24","12","false","10801","8.5","12","12","false","0","10801","515877615"
"4.854221794563387","7.561830823507332","0.2060062441151692","0.3076923076923077","11","26","13","false","14661","12.923076923076923","13","13","false","0","14661","1192211348"
"5.036564830406543","0.5517026215909933","0.19854802502746335","0.5333333333333333","11","12","6","false","21321","12.333333333333334","6","6","false","0","21321","113713781"
"5.211691123406303","0.0","0.1918762981767828","1.0","11","8","4","false","22376","14.0","4","4","false","0","22376","0"
"5.211691123406303","0.0","0.1918762981767828","1.0","11","8","4","false","24295","14.0","4","4","false","0","24295","0"
"6.452249218186192","0.5146115310909182","0.15498471404071285","0.3333333333333333","13","6","3","false","5485","3.0","3","3","false","0","5485","39214891"
"6.045946596102959","0.5571611037206324","0.16540007161898698","0.2","12","10","5","false","23870","5.4","5","5","false","0","23870","37509962"
"5.921337503006976","3.180367982111183","0.16888076376193378","0.26666666666666666","12","12","6","false","6638","3.8333333333333335","6","6","false","0","6638","293388056"
"5.833533798412317","0.7450110821108822","0.17142268041237113","0.0","11","4","2","false","17754","9.0","2","2","false","0","17754","61880770"
"6.833293240317537","0.0","0.14634232204463846","0.0","12","2","1","false","25674","2.0","1","1","false","0","25674","0"
"6.08708203031032","0.14393624851766526","0.16428232690483718","0.0","12","4","2","false","9273","5.0","2","2","false","0","9273","8717695"
"5.733221072889103","2.2631020713940346","0.17442201988839004","0.42857142857142855","12","14","7","false","9325","9.428571428571429","7","7","false","0","9325","193501374"
"5.91291796968968","0.0","0.1691212367778682","1.0","12","4","2","false","2783","4.5","2","2","false","0","2783","0"
"5.91291796968968","0.0","0.1691212367778682","1.0","12","4","2","false","9408","4.5","2","2","false","0","9408","0"
"4.828000962232379","25.40989158042494","0.20712506228201294","0.008333333333333333","10","32","16","false","12927","6.4375","16","16","false","0","12927","2148901140"
"5.671638200625451","0.0","0.17631590109004538","1.0","11","4","2","false","13310","8.0","2","2","false","0","13310","0"
"4.855905701226846","32.56202177692757","0.20593480630139702","0.07862903225806452","10","64","32","false","6264","6.40625","32","32","false","0","6264","2751605115"
"5.183545826317055","1.019384108518396","0.1929181362539447","0.2","11","12","6","false","7204","9.333333333333334","6","6","false","0","7204","104623448"
"5.026701948520568","1.7937940976219346","0.198937595712098","0.2","11","10","5","false","12247","14.0","5","5","false","0","12247","203523877"
"4.933124849651191","4.62432876514699","0.2027112693226703","0.25","10","16","8","false","19433","14.375","8","8","false","0","19433","587019565"
"5.771950926148665","0.0","0.17325164624489456","0.0","11","2","1","false","18867","14.0","1","1","false","0","18867","0"
"5.771950926148665","0.0","0.17325164624489456","0.0","11","2","1","false","24943","14.0","1","1","false","0","24943","0"
"5.67332210728891","0.0","0.17626356852103123","0.0","11","2","1","false","731","22.0","1","1","false","0","731","0"
"5.338224681260525","7.110868939753601","0.18732819611554233","0.19444444444444445","11","18","9","false","17359","6.111111111111111","9","9","false","0","17359","498653167"
"5.361318258359394","2.837910497107862","0.18652129043837212","0.5","11","8","4","false","23558","11.75","4","4","false","0","23558","187905650"
"5.540534038970411","0.0","0.18048801667245573","0.0","11","2","1","false","6828","12.0","1","1","false","0","6828","0"
"5.540534038970411","0.0","0.18048801667245573","0.0","11","2","1","false","25319","12.0","1","1","false","0","25319","0"
"6.948039451527544","5.064914798675564","0.14392549250424125","0.5","13","8","4","false","3953","3.75","4","4","false","0","3953","406804696"
"5.842675006013953","2.2860721152067547","0.1711544795783926","0.0","11","8","4","false","13196","4.0","4","4","false","0","13196","159743952"
"7.945874428674525","2.870045377267561","0.12585147285882958","0.26666666666666666","14","12","6","false","15568","2.5","6","6","false","0","15568","230888184"
"7.946596102958865","0.0","0.12584004359145123","1.0","14","6","3","false","17163","4.333333333333333","3","3","false","0","17163","0"
"7.946596102958865","0.0","0.12584004359145123","1.0","14","6","3","false","22954","4.333333333333333","3","3","false","0","22954","0"
"6.135434207361078","0.0","0.16298764948049402","1.0","12","4","2","false","14606","6.5","2","2","false","0","14606","0"
"4.664662015876834","28.024940258683614","0.21437780413593938","0.14545454545454545","10","22","11","false","22144","16.727272727272727","11","11","false","0","22144","2342228780"
"5.441905220110657","0.0","0.18375917248695958","1.0","11","10","5","false","1840","8.4","5","5","false","0","1840","0"
"5.441905220110657","0.0","0.18375917248695958","1.0","11","10","5","false","4713","8.4","5","5","false","0","4713","0"
"5.441905220110657","0.0","0.18375917248695958","1.0","11","10","5","false","6824","8.4","5","5","false","0","6824","0"
"5.441905220110657","0.0","0.18375917248695958","1.0","11","10","5","false","12492","8.4","5","5","false","0","12492","0"
"6.574933846523935","0.0","0.15209278501390314","0.0","11","2","1","false","10478","7.0","1","1","false","0","10478","0"
"6.574933846523935","0.0","0.15209278501390314","0.0","11","2","1","false","16675","7.0","1","1","false","0","16675","0"
"7.360115467885494","3.6265289851666647","0.1358674336514577","0.25","14","16","8","false","13859","3.125","8","8","false","0","13859","272953178"
"8.359153235506374","1.082974483477317E-4","0.11962934185156408","0.6666666666666666","15","8","4","false","4141","4.0","4","4","false","0","4141","3742"
"8.359393793601155","0.0","0.11962589928057553","1.0","15","6","3","false","9267","5.0","3","3","false","0","9267","0"
"6.363242723117633","6.971680018138463","0.15715257825495235","0.2","13","12","6","false","11052","4.666666666666667","6","6","false","0","11052","525672304"
"7.361318258359394","0.0","0.13584523381588837","1.0","14","6","3","false","16091","5.666666666666667","3","3","false","0","16091","0"
"8.359634351695934","0.0","0.11962245690771489","1.0","15","4","2","false","17755","6.0","2","2","false","0","17755","0"
"8.359874909790715","0.0","0.119619014732965","0.0","15","2","1","false","20053","8.0","1","1","false","0","20053","0"
"8.359393793601155","0.0","0.11962589928057553","1.0","15","6","3","false","22395","5.0","3","3","false","0","22395","0"
"7.361318258359394","0.0","0.13584523381588837","1.0","14","6","3","false","26168","5.666666666666667","3","3","false","0","26168","0"
"6.214818378638441","0.0","0.16090574801625704","0.0","11","2","1","false","8378","10.0","1","1","false","0","8378","0"
"5.920134712533077","0.9616227051800617","0.16891507517269402","0.0","11","8","4","false","16607","4.75","4","4","false","0","16607","77732811"
"1.0","4.0","1.0","0.0","1","10","5","false","2054","1.0","5","5","false","0","2054","80"
"1.8","0.0","0.5555555555555556","0.0","2","2","1","false","1552","5.0","1","1","false","0","1552","0"
"1.8","0.0","0.5555555555555556","0.0","2","2","1","false","8719","5.0","1","1","false","0","8719","0"
"1.8","0.0","0.5555555555555556","0.0","2","2","1","false","9760","5.0","1","1","false","0","9760","0"
"1.8","0.0","0.5555555555555556","0.0","2","2","1","false","10355","5.0","1","1","false","0","10355","0"
"1.8","0.0","0.5555555555555556","0.0","2","2","1","false","13741","5.0","1","1","false","0","13741","0"
"5.482559538128458","1.0730411199034326","0.18239656004563204","0.4","11","10","5","false","5116","9.2","5","5","false","0","5116","119719204"
"5.961029588645658","3.6341438167284883","0.16775625504439062","0.19696969696969696","12","24","12","false","9629","5.666666666666667","12","12","false","0","9629","661313759"
"5.441183545826317","4.611361283165631","0.18378354480746276","0.16363636363636364","11","22","11","false","7087","7.818181818181818","11","11","false","0","7087","1157746878"
"6.223478470050517","0.0","0.16068184453635345","1.0","12","6","3","false","9984","11.0","3","3","false","0","9984","0"
"5.7385133509742605","0.3167577131086904","0.1742611611821421","0.6666666666666666","12","8","4","false","10153","11.75","4","4","false","0","10153","149576214"
"6.017560740918932","0.7455159456822548","0.16618029182490504","0.4","13","12","6","false","10543","9.833333333333334","6","6","false","0","10543","135392020"
"6.960548472456098","0.0","0.1436668394677726","1.0","13","4","2","false","10967","7.0","2","2","false","0","10967","0"
"6.960548472456098","0.0","0.1436668394677726","1.0","13","4","2","false","16336","7.0","2","2","false","0","16336","0"
"6.960548472456098","0.0","0.1436668394677726","1.0","13","4","2","false","20435","7.0","2","2","false","0","20435","0"
"6.960548472456098","0.0","0.1436668394677726","1.0","13","4","2","false","20479","7.0","2","2","false","0","20479","0"
"6.9598267981717585","0.0","0.14368173648555232","1.0","13","4","2","false","21433","9.5","2","2","false","0","21433","0"
"5.4772672600433","3.264239762794728","0.18257279634590892","0.28888888888888886","12","20","10","false","25569","9.2","10","10","false","0","25569","533056709"
"6.461630983882608","0.19730964493527023","0.15475968876810245","0.3333333333333333","13","14","7","false","25783","5.428571428571429","7","7","false","0","25783","38956558"
"6.475823911474621","0.0","0.15442050520059436","1.0","13","6","3","false","7039","6.666666666666667","3","3","false","0","7039","0"
"6.475823911474621","0.0","0.15442050520059436","1.0","13","6","3","false","12166","6.666666666666667","3","3","false","0","12166","0"
"6.984363723839307","0.0","0.1431769649376593","1.0","14","4","2","false","14970","6.5","2","2","false","0","14970","0"
"5.502285301900409","2.3544231303819725","0.18174266602544484","0.2777777777777778","11","18","9","false","7277","7.777777777777778","9","9","false","0","7277","309222657"
"5.931922059177292","0.0","0.16857942333427955","1.0","11","6","3","false","16766","10.333333333333334","3","3","false","0","16766","0"
"5.773153716622565","0.0","0.17321555064794367","1.0","11","6","3","false","16770","11.333333333333334","3","3","false","0","16770","0"
"5.91219629540534","0.0","0.16914188062009197","1.0","11","6","3","false","16858","10.666666666666666","3","3","false","0","16858","0"
"5.609814770267019","10.057634102501021","0.17825900514579762","0.12121212121212122","11","24","12","false","17113","5.25","12","12","false","0","17113","871614220"
"5.91219629540534","0.0","0.16914188062009197","1.0","11","6","3","false","17389","10.666666666666666","3","3","false","0","17389","0"
"5.496511907625692","36.617914278770805","0.18193356383211517","0.2","11","20","10","false","18408","9.3","10","10","false","0","18408","3403259973"
"5.9249458744286745","0.003479376291591389","0.16877791311408852","0.7","11","10","5","false","19089","8.6","5","5","false","0","19089","237369"
"5.929757036324272","0.019449981462853018","0.16864097363083166","0.6666666666666666","11","8","4","false","20033","8.75","4","4","false","0","20033","2363662"
"5.967765215299495","2.3364764564406304","0.16756691389874234","0.3333333333333333","11","8","4","false","23429","7.5","4","4","false","0","23429","266301011"
"5.705556891989415","0.3050315572865979","0.1752677291508559","0.6666666666666666","11","8","4","false","24578","9.75","4","4","false","0","24578","58378459"
"5.52080827519846","1.604715953382091","0.18113289760348586","0.16666666666666666","11","8","4","false","4724","11.0","4","4","false","0","4724","120051438"
"5.450805869617513","0.36408522238117397","0.18345911116995453","0.6666666666666666","11","8","4","false","6904","11.75","4","4","false","0","6904","32142881"
"5.5973057493384655","0.0","0.17865738353102972","0.0","11","2","1","false","7452","26.0","1","1","false","0","7452","0"
"5.231416887178254","16.479193212721434","0.19115280268542786","0.2","11","30","15","false","12491","9.0","15","15","false","0","12491","1334414493"
"5.331248496511908","6.766802282638393","0.18757332370724664","0.4444444444444444","11","18","9","false","13369","11.555555555555555","9","9","false","0","13369","576220199"
"5.5973057493384655","0.0","0.17865738353102972","0.0","11","2","1","false","14346","26.0","1","1","false","0","14346","0"
"5.520086600914121","1.9644750900323937","0.18115657820194359","0.17857142857142858","11","16","8","false","18065","7.0","8","8","false","0","18065","160195734"
"5.315852778445994","5.643011240206012","0.18811657163544213","0.2222222222222222","11","18","9","false","18271","7.333333333333333","9","9","false","0","18271","395111781"
"5.5973057493384655","0.0","0.17865738353102972","0.0","11","2","1","false","19244","26.0","1","1","false","0","19244","0"
"5.5973057493384655","0.0","0.17865738353102972","0.0","11","2","1","false","23989","26.0","1","1","false","0","23989","0"
"4.9514072648544625","10.793010452199146","0.20196278482242627","0.13636363636363635","10","24","12","false","10983","7.166666666666667","12","12","false","0","10983","880387296"
"6.203752706278566","0.0","0.1611927566016519","0.0","12","2","1","false","4642","5.0","1","1","false","0","4642","0"
"5.3853740678373825","0.8016088522764607","0.18568812257113504","0.16666666666666666","11","8","4","false","16708","5.5","4","4","false","0","16708","67572230"
"6.0841953331729615","0.0","0.164360272022774","0.0","12","2","1","false","8231","9.0","1","1","false","0","8231","0"
"5.471974981958143","2.8218794782042758","0.18274937354376403","0.14285714285714285","12","16","8","false","9616","7.875","8","8","false","0","9616","271113277"
"6.786624969930238","0.0","0.1473486459662555","0.0","12","2","1","false","24149","2.0","1","1","false","0","24149","0"
"5.789752225162377","0.0","0.17271896293834135","1.0","11","6","3","false","1519","8.333333333333334","3","3","false","0","1519","0"
"4.7654558575896075","6.183715101036883","0.2098435133770823","0.19607843137254902","10","36","18","false","8768","11.833333333333334","18","18","false","0","8768","882463319"
"5.08539812364686","0.11284236666297816","0.19664143803216652","0.7142857142857143","10","14","7","false","9937","17.142857142857142","7","7","false","0","9937","34040108"
"5.168871782535482","0.9483713606608914","0.19346581654023365","0.6190476190476191","10","14","7","false","24270","14.285714285714286","7","7","false","0","24270","196581620"
"5.788789992783257","2.3345828539729014","0.17274767287234044","0.4","11","12","6","false","25435","5.333333333333333","6","6","false","0","25435","356670402"
"6.2694250661534765","9.428529009245626","0.1595042590745146","0.5","13","8","4","false","5181","5.0","4","4","false","0","5181","864444864"
"8.263651671878758","0.0","0.12101187703772706","0.0","15","2","1","false","6316","4.0","1","1","false","0","6316","0"
"8.263170555689198","0.9857624452927133","0.121018922852984","0.0","15","4","2","false","17235","2.5","2","2","false","0","17235","89986567"
"5.221072889102718","3.8315459712265643","0.19153151492812387","0.3090909090909091","11","22","11","false","2870","7.454545454545454","11","11","false","0","2870","337686346"
"5.71686312244407","0.0","0.1749211024616032","1.0","11","8","4","false","2536","10.25","4","4","false","0","2536","0"
"5.420976665864806","0.06611855772042724","0.18446860439316617","0.9","11","10","5","false","9207","10.4","5","5","false","0","9207","14438353"
"5.570363242723118","0.11469178862417106","0.17952150630506133","0.5","11","8","4","false","9732","9.5","4","4","false","0","9732","14397079"
"5.123887418811643","4.860279832741661","0.1951643192488263","0.32142857142857145","11","16","8","false","12654","11.375","8","8","false","0","12654","465470407"
"5.71686312244407","0.0","0.1749211024616032","1.0","11","8","4","false","16041","10.25","4","4","false","0","16041","0"
"5.219388982439259","7.906325877794596","0.19159330783057565","0.19230769230769232","10","26","13","false","22555","5.384615384615385","13","13","false","0","22555","649067283"
"4.929516478229492","11.441655414746005","0.20285965254733557","0.20512820512820512","11","26","13","false","24753","7.6923076923076925","13","13","false","0","24753","852788569"
"6.220832331007938","0.0","0.16075019334880125","0.0","12","2","1","false","25870","11.0","1","1","false","0","25870","0"
"6.217945633870579","0.0","0.1608248220365212","1.0","11","4","2","false","5830","8.5","2","2","false","0","5830","0"
"6.219148424344479","0.0","0.16079371833056125","0.0","11","2","1","false","10991","13.0","1","1","false","0","10991","0"
"5.71806591291797","1.0244265664849443","0.174884307951199","0.5","11","8","4","false","17306","7.0","4","4","false","0","17306","60098461"
"6.219148424344479","0.0","0.16079371833056125","0.0","11","2","1","false","19924","13.0","1","1","false","0","19924","0"
"6.407024296367573","3.047130053948452","0.1560786964030938","0.4666666666666667","12","12","6","false","10923","5.0","6","6","false","0","10923","363838030"
"6.407986528746692","0.0","0.15605525940385917","1.0","12","6","3","false","11821","7.333333333333333","3","3","false","0","11821","0"
"6.407745970651913","0.6226427216821563","0.15606111799376807","0.6666666666666666","12","8","4","false","16013","6.25","4","4","false","0","16013","123326924"
"6.407986528746692","0.0","0.15605525940385917","1.0","12","6","3","false","21469","7.333333333333333","3","3","false","0","21469","0"
"7.105605003608371","0.0","0.14073396980161149","1.0","13","4","2","false","11944","7.0","2","2","false","0","11944","0"
"6.460428193408708","1.138433561773757","0.1547885016383676","0.13333333333333333","13","12","6","false","16429","4.166666666666667","6","6","false","0","16429","137489949"
"7.105605003608371","0.0","0.14073396980161149","1.0","13","4","2","false","25784","7.0","2","2","false","0","25784","0"
"5.552321385614626","3.6424718778444505","0.18010484814349467","0.19444444444444445","12","18","9","false","21608","6.111111111111111","9","9","false","0","21608","364250417"
"6.060139523694972","0.26448535438675685","0.1650127024452207","0.3333333333333333","12","6","3","false","23092","9.666666666666666","3","3","false","0","23092","40509892"
"7.460187635313928","0.0","0.13404488585063848","0.0","14","2","1","false","25571","6.0","1","1","false","0","25571","0"
"6.551840269425067","0.0","0.1526288735497136","1.0","13","4","2","false","5444","6.0","2","2","false","0","5444","0"
"5.743083954775078","0.0","0.17412247633408728","1.0","12","6","3","false","11734","13.333333333333334","3","3","false","0","11734","0"
"6.551599711330287","4.607416829759189E-5","0.15263447769414357","0.6666666666666666","13","6","3","false","13931","4.333333333333333","3","3","false","0","13931","1592"
"6.551840269425067","0.0","0.1526288735497136","1.0","13","4","2","false","21549","6.0","2","2","false","0","21549","0"
"6.155881645417368","0.0","0.16244626807346618","1.0","13","4","2","false","25615","11.0","2","2","false","0","25615","0"
"7.615107048352177","0.0","0.1313179176143543","0.0","13","2","1","false","8476","7.0","1","1","false","0","8476","0"
"6.398123646860717","0.0","0.1562958228371621","1.0","12","4","2","false","13388","8.0","2","2","false","0","13388","0"
"6.00024055809478","2.851249730393945","0.1666599847652648","0.23809523809523808","12","14","7","false","12739","6.285714285714286","7","7","false","0","12739","206043895"
"6.796728409910994","0.0","0.14712960996673036","1.0","13","6","3","false","4847","7.666666666666667","3","3","false","0","4847","0"
"6.796728409910994","0.0","0.14712960996673036","1.0","13","6","3","false","10842","7.666666666666667","3","3","false","0","10842","0"
"6.098628818859755","10.326459947531198","0.16397128431681918","0.16666666666666666","13","26","13","false","11293","4.769230769230769","13","13","false","0","11293","1024288944"
"6.187875872023094","1.5349615204762692","0.16160634451658049","0.16666666666666666","13","8","4","false","25125","6.0","4","4","false","0","25125","123523803"
"6.170315131104162","0.06005525424749836","0.1620662768031189","0.8333333333333334","12","8","4","false","1672","5.5","4","4","false","0","1672","11293236"
"6.170315131104162","0.06005525424749836","0.1620662768031189","0.8333333333333334","12","8","4","false","8079","5.5","4","4","false","0","8079","11293236"
"5.5090209285542455","1.8630336114796546","0.18152045762193791","0.4","11","12","6","false","11461","7.833333333333333","6","6","false","0","11461","184388203"
"6.52056771710368","0.0","0.15336087951007157","1.0","12","6","3","false","16755","5.666666666666667","3","3","false","0","16755","0"
"5.625451046427712","5.3119316519099","0.17776352362625614","0.14285714285714285","12","16","8","false","1711","6.5","8","8","false","0","1711","569455195"
"6.625210488332932","0.0","0.15093860063178535","0.0","13","2","1","false","3174","8.0","1","1","false","0","3174","0"
"6.625210488332932","0.0","0.15093860063178535","0.0","13","2","1","false","6726","8.0","1","1","false","0","6726","0"
"6.596584075054126","2.0879058111564257","0.15159361096929472","0.4","13","10","5","false","6813","4.0","5","5","false","0","6813","226840255"
"6.481116189559779","0.0","0.15429441021453494","1.0","13","4","2","false","13703","8.0","2","2","false","0","13703","0"
"5.767620880442627","0.6524303591599001","0.1733817150483817","0.4642857142857143","12","16","8","false","20046","7.25","8","8","false","0","20046","70654993"
"6.619437094058215","0.0","0.15107024748337392","1.0","13","4","2","false","20854","6.5","2","2","false","0","20854","0"
"6.378397883088766","0.0","0.1567791815953234","1.0","12","6","3","false","5411","4.666666666666667","3","3","false","0","5411","0"
"6.3755111859514075","7.602372808090902","0.15685016790552012","0.16666666666666666","12","8","4","false","5503","4.0","4","4","false","0","5503","489862776"
"6.378397883088766","0.0","0.1567791815953234","1.0","12","6","3","false","10390","4.666666666666667","3","3","false","0","10390","0"
"6.378397883088766","0.0","0.1567791815953234","1.0","12","6","3","false","11186","4.666666666666667","3","3","false","0","11186","0"
"5.0396920856386815","0.08064653523536532","0.19842482100238665","0.5","11","8","4","false","7522","24.25","4","4","false","0","7522","21308529"
"5.590089006495068","0.0","0.1788880282296239","0.0","12","2","1","false","9944","20.0","1","1","false","0","9944","0"
"5.542699061823431","0.7712409440527626","0.18041751660084196","0.5","12","8","4","false","17086","11.25","4","4","false","0","17086","97973937"
"5.5710849170074574","0.0","0.17949825121982815","1.0","12","6","3","false","21341","15.666666666666666","3","3","false","0","21341","0"
"5.448159730574933","0.10431621710788475","0.18354821617802897","0.4666666666666667","11","12","6","false","16010","11.5","6","6","false","0","16010","16378638"
"5.573971614144816","0.0","0.1794052910966294","1.0","11","4","2","false","22696","19.5","2","2","false","0","22696","0"
"5.511907625691604","0.0","0.1814253916990355","1.0","11","8","4","false","25585","13.75","4","4","false","0","25585","0"
"6.952128939138802","0.0","0.14384083044982698","1.0","12","4","2","false","3526","3.0","2","2","false","0","3526","0"
"6.952128939138802","0.0","0.14384083044982698","1.0","12","4","2","false","15786","3.0","2","2","false","0","15786","0"
"4.935770988693769","5.024128619247444","0.20260259284530657","0.2909090909090909","10","22","11","false","135","10.090909090909092","11","11","false","0","135","842885640"
"5.307433245128698","0.0","0.188414993427911","1.0","11","8","4","false","1776","12.5","4","4","false","0","1776","0"
"4.9333654077459705","0.5414039921218393","0.20270138482543398","0.3611111111111111","11","18","9","false","4102","11.666666666666666","9","9","false","0","4102","71351505"
"5.257637719509262","0.03156399780622026","0.19019948755490482","0.7","11","10","5","false","12311","12.2","5","5","false","0","12311","5196153"
"5.2605244166466205","3.0720390395748662","0.19009511615145416","0.25","11","18","9","false","12675","8.88888888888889","9","9","false","0","12675","290557950"
"5.307433245128698","0.0","0.188414993427911","1.0","11","8","4","false","15816","12.5","4","4","false","0","15816","0"
"5.272071205196055","0.011150549495233607","0.18967877349881365","0.7","10","10","5","false","19945","11.2","5","5","false","0","19945","1660246"
"5.5092614866490255","0.035720491087349884","0.18151253165662387","0.6","11","10","5","false","26176","9.4","5","5","false","0","26176","5249200"
"5.82631705556892","0.0","0.17163501238645748","1.0","12","6","3","false","1550","7.0","3","3","false","0","1550","0"
"5.82631705556892","0.0","0.17163501238645748","1.0","12","6","3","false","20952","7.0","3","3","false","0","20952","0"
"5.62978109213375","0.06829597133688803","0.17762679998290817","0.6666666666666666","12","6","3","false","24280","8.666666666666666","3","3","false","0","24280","10266098"
"5.427952850613424","0.0","0.18423151923417833","1.0","11","10","5","false","365","14.0","5","5","false","0","365","0"
"4.8811643011787345","1.2177940042426878","0.2048691538120349","0.5333333333333333","11","12","6","false","9511","13.333333333333334","6","6","false","0","9511","203660791"
"5.427952850613424","0.0","0.18423151923417833","1.0","11","10","5","false","14552","14.0","5","5","false","0","14552","0"
"5.427952850613424","0.0","0.18423151923417833","1.0","11","10","5","false","15585","14.0","5","5","false","0","15585","0"
"5.483281212412797","2.302405783439256","0.18237255418092482","0.5","11","8","4","false","16906","14.0","4","4","false","0","16906","279862788"
"4.918691363964397","2.573707680649899","0.20330610847557098","0.6","11","10","5","false","17187","15.6","5","5","false","0","17187","259481011"
"5.34856867933606","5.746708423446553","0.18696590806872357","0.21794871794871795","11","26","13","false","18579","7.538461538461538","13","13","false","0","18579","1004709635"
"4.84700505171999","5.118403622453779","0.20631296838552782","0.32727272727272727","10","22","11","false","18736","12.636363636363637","11","11","false","0","18736","1195138455"
"4.943228289631946","2.649730460068615","0.20229694875663048","0.2","11","10","5","false","19791","20.6","5","5","false","0","19791","354530122"
"5.246090930959827","3.178781061266501","0.19061812179016874","0.23809523809523808","11","14","7","false","1229","12.142857142857142","7","7","false","0","1229","351445181"
"6.309357709886938","0.0","0.15849473844746073","0.0","11","2","1","false","1862","15.0","1","1","false","0","1862","0"
"6.309357709886938","0.0","0.15849473844746073","0.0","11","2","1","false","3194","15.0","1","1","false","0","3194","0"
"6.309357709886938","0.0","0.15849473844746073","0.0","11","2","1","false","3532","15.0","1","1","false","0","3532","0"
"6.309357709886938","0.0","0.15849473844746073","0.0","11","2","1","false","5400","15.0","1","1","false","0","5400","0"
"4.947798893432764","23.895085642022348","0.20211007390120575","0.05128205128205128","11","26","13","false","7154","8.615384615384615","13","13","false","0","7154","1699910979"
"6.309117151792158","0.0","0.15850078163724404","1.0","11","4","2","false","9946","9.0","2","2","false","0","9946","0"
"5.379360115467885","2.7544428594241364","0.1858957159466953","0.3055555555555556","10","18","9","false","10381","10.777777777777779","9","9","false","0","10381","353536222"
"5.127495790233342","3.871790384486718","0.19502697630776447","0.2857142857142857","10","16","8","false","11107","16.125","8","8","false","0","11107","414458670"
"6.309357709886938","0.0","0.15849473844746073","0.0","11","2","1","false","17934","15.0","1","1","false","0","17934","0"
"5.835458263170556","0.0","0.17136614725039162","1.0","11","6","3","false","22721","11.333333333333334","3","3","false","0","22721","0"
"6.309357709886938","0.0","0.15849473844746073","0.0","11","2","1","false","24129","15.0","1","1","false","0","24129","0"
"6.076978590329564","0.0","0.16455545879186131","1.0","11","34","17","false","215","18.235294117647058","17","17","false","0","215","0"
"6.076978590329564","0.0","0.16455545879186131","1.0","11","34","17","false","185","18.235294117647058","17","17","false","0","185","0"
"6.076978590329564","0.0","0.16455545879186131","1.0","11","34","17","false","351","18.235294117647058","17","17","false","0","351","0"
"6.076978590329564","0.0","0.16455545879186131","1.0","11","34","17","false","1074","18.235294117647058","17","17","false","0","1074","0"
"6.076978590329564","0.0","0.16455545879186131","1.0","11","34","17","false","1858","18.235294117647058","17","17","false","0","1858","0"
"6.076978590329564","0.0","0.16455545879186131","1.0","11","34","17","false","4512","18.235294117647058","17","17","false","0","4512","0"
"6.076978590329564","0.0","0.16455545879186131","1.0","11","34","17","false","6892","18.235294117647058","17","17","false","0","6892","0"
"6.076978590329564","0.0","0.16455545879186131","1.0","11","34","17","false","8280","18.235294117647058","17","17","false","0","8280","0"
"6.076978590329564","0.0","0.16455545879186131","1.0","11","34","17","false","14542","18.235294117647058","17","17","false","0","14542","0"
"6.076978590329564","0.0","0.16455545879186131","1.0","11","34","17","false","17751","18.235294117647058","17","17","false","0","17751","0"
"6.076978590329564","0.0","0.16455545879186131","1.0","11","34","17","false","18095","18.235294117647058","17","17","false","0","18095","0"
"6.076978590329564","0.0","0.16455545879186131","1.0","11","34","17","false","18143","18.235294117647058","17","17","false","0","18143","0"
"6.076978590329564","0.0","0.16455545879186131","1.0","11","34","17","false","18649","18.235294117647058","17","17","false","0","18649","0"
"6.076978590329564","0.0","0.16455545879186131","1.0","11","34","17","false","18943","18.235294117647058","17","17","false","0","18943","0"
"6.076978590329564","0.0","0.16455545879186131","1.0","11","34","17","false","19573","18.235294117647058","17","17","false","0","19573","0"
"5.2788068318498915","7.898729484148428","0.1894367480860372","0.4894894894894895","10","74","37","false","22601","19.35135135135135","37","37","false","0","22601","617647487"
"6.076978590329564","0.0","0.16455545879186131","1.0","11","34","17","false","22793","18.235294117647058","17","17","false","0","22793","0"
"5.342073610777002","0.0","0.18719322736074212","1.0","10","40","20","false","3877","22.15","20","20","false","0","3877","0"
"5.342073610777002","0.0","0.18719322736074212","1.0","10","40","20","false","4354","22.15","20","20","false","0","4354","0"
"5.342073610777002","0.0","0.18719322736074212","1.0","10","40","20","false","5412","22.15","20","20","false","0","5412","0"
"5.342073610777002","0.0","0.18719322736074212","1.0","10","40","20","false","6544","22.15","20","20","false","0","6544","0"
"5.342073610777002","0.0","0.18719322736074212","1.0","10","40","20","false","7357","22.15","20","20","false","0","7357","0"
"5.342073610777002","0.0","0.18719322736074212","1.0","10","40","20","false","7719","22.15","20","20","false","0","7719","0"
"5.342073610777002","0.0","0.18719322736074212","1.0","10","40","20","false","10477","22.15","20","20","false","0","10477","0"
"5.342073610777002","0.0","0.18719322736074212","1.0","10","40","20","false","11445","22.15","20","20","false","0","11445","0"
"5.342073610777002","0.0","0.18719322736074212","1.0","10","40","20","false","12788","22.15","20","20","false","0","12788","0"
"5.342073610777002","0.0","0.18719322736074212","1.0","10","40","20","false","18185","22.15","20","20","false","0","18185","0"
"5.342073610777002","0.0","0.18719322736074212","1.0","10","40","20","false","19246","22.15","20","20","false","0","19246","0"
"5.342073610777002","0.0","0.18719322736074212","1.0","10","40","20","false","19463","22.15","20","20","false","0","19463","0"
"5.342073610777002","0.0","0.18719322736074212","1.0","10","40","20","false","20780","22.15","20","20","false","0","20780","0"
"5.342073610777002","0.0","0.18719322736074212","1.0","10","40","20","false","21861","22.15","20","20","false","0","21861","0"
"5.342073610777002","0.0","0.18719322736074212","1.0","10","40","20","false","22284","22.15","20","20","false","0","22284","0"
"5.342073610777002","0.0","0.18719322736074212","1.0","10","40","20","false","22741","22.15","20","20","false","0","22741","0"
"5.342073610777002","0.0","0.18719322736074212","1.0","10","40","20","false","23514","22.15","20","20","false","0","23514","0"
"6.150829925426991","0.0","0.16257968633892603","0.0","11","2","1","false","18161","8.0","1","1","false","0","18161","0"
"5.779889343276401","1.1336851833115194","0.17301369292878846","0.0","11","4","2","false","11093","4.5","2","2","false","0","11093","89389096"
"6.0938176569641564","0.0","0.1641007421443234","1.0","12","4","2","false","165","7.5","2","2","false","0","165","0"
"6.094298773153716","0.0","0.1640877871634957","1.0","12","4","2","false","293","6.5","2","2","false","0","293","0"
"5.58672119316815","3.0274925347435837","0.17899586634516018","0.2","12","12","6","false","3228","6.5","6","6","false","0","3228","215747516"
"6.094058215058936","0.530270381278792","0.16409426439821578","0.3333333333333333","12","6","3","false","6556","4.333333333333333","3","3","false","0","6556","32876191"
"6.0930959826798174","4.214940104738855","0.16412017845157723","0.4","12","10","5","false","17194","4.2","5","5","false","0","17194","262238654"
"5.555448640846764","7.572005703544285","0.1800034641032303","0.06666666666666667","10","12","6","false","6524","5.166666666666667","6","6","false","0","6524","616757370"
"6.237190281452971","0.0","0.1603286022832459","1.0","11","4","2","false","22436","3.5","2","2","false","0","22436","0"
"6.237190281452971","0.0","0.1603286022832459","1.0","11","4","2","false","9504","3.5","2","2","false","0","9504","0"
"6.236949723358191","1.2938593089384118","0.16033478613028887","0.0","11","4","2","false","5359","3.0","2","2","false","0","5359","106802986"
"5.685109453933125","0.3427261244022557","0.17589810857698981","0.3333333333333333","12","6","3","false","2915","12.0","3","3","false","0","2915","26120687"
"5.723358191003127","3.038590240716132","0.17472259583053126","0.26666666666666666","11","12","6","false","10956","4.666666666666667","6","6","false","0","10956","239612747"
"5.779167668992062","3.6247447938401733","0.17303529803529802","0.3333333333333333","11","6","3","false","20089","6.666666666666667","3","3","false","0","20089","296457177"
"5.787106086119798","0.0","0.172797938230037","1.0","11","4","2","false","25358","6.0","2","2","false","0","25358","0"
"6.722877074813567","0.0","0.1487458403406448","1.0","12","4","2","false","2350","4.0","2","2","false","0","2350","0"
"6.503006976184748","0.0","0.15377501572152555","1.0","12","6","3","false","2385","6.0","3","3","false","0","2385","0"
"6.503006976184748","0.0","0.15377501572152555","1.0","12","6","3","false","20783","6.0","3","3","false","0","20783","0"
"6.722877074813567","0.0","0.1487458403406448","1.0","12","4","2","false","25405","4.0","2","2","false","0","25405","0"
"6.029107529468367","0.0","0.16586202769022065","1.0","12","4","2","false","15209","10.0","2","2","false","0","15209","0"
"5.589126774115949","0.0","0.1789188258586554","1.0","11","6","3","false","15669","12.333333333333334","3","3","false","0","15669","0"
"6.357709886937696","0.0","0.1572893412539256","1.0","13","4","2","false","10807","5.5","2","2","false","0","10807","0"
"6.3502525859995185","2.388783560961761","0.1574740510644746","0.2","13","12","6","false","21466","3.0","6","6","false","0","21466","292005903"
"6.2879480394515275","0.0","0.15903439305252687","0.0","12","2","1","false","6832","9.0","1","1","false","0","6832","0"
"6.2251623767139765","0.0","0.16063838009119716","1.0","12","4","2","false","19557","11.0","2","2","false","0","19557","0"
"5.459706519124368","0.1671846541920255","0.18316002819880156","0.5333333333333333","11","12","6","false","1090","11.333333333333334","6","6","false","0","1090","36458015"
"5.342795285061342","0.0","0.18716794236830256","1.0","11","6","3","false","3990","14.333333333333334","3","3","false","0","3990","0"
"5.514313206639404","0.0","0.1813462461283427","1.0","11","4","2","false","4635","17.0","2","2","false","0","4635","0"
"5.776280971854703","0.0","0.17312177244710977","1.0","11","4","2","false","4759","9.5","2","2","false","0","4759","0"
"5.342795285061342","0.0","0.18716794236830256","1.0","11","6","3","false","15166","14.333333333333334","3","3","false","0","15166","0"
"5.642530671157084","0.6776611960872135","0.17722544338335608","0.16666666666666666","11","8","4","false","24860","5.5","4","4","false","0","24860","61890210"
"5.458503728650469","0.24774197099747539","0.18320038781895906","0.5","11","10","5","false","6375","7.6","5","5","false","0","6375","30826256"
"5.603560259802743","0.0","0.17845797200995964","1.0","11","6","3","false","10519","10.666666666666666","3","3","false","0","10519","0"
"6.9160452249218185","0.0","0.14459130434782608","0.0","13","2","1","false","20230","8.0","1","1","false","0","20230","0"
"6.9158046668270385","0.0","0.14459633378552297","1.0","13","4","2","false","4775","5.0","2","2","false","0","4775","0"
"6.585758960789031","0.0","0.15184278774153487","1.0","12","4","2","false","7095","6.5","2","2","false","0","7095","0"
"6.9160452249218185","0.0","0.14459130434782608","0.0","13","2","1","false","9138","8.0","1","1","false","0","9138","0"
"5.879480394515276","1.3824554905587316","0.17008305715805408","0.2","11","10","5","false","9432","6.6","5","5","false","0","9432","117090171"
"6.9158046668270385","0.0","0.14459633378552297","1.0","13","4","2","false","20229","5.0","2","2","false","0","20229","0"
"5.819340870820303","0.10462614936347862","0.1718407672274813","0.0","11","4","2","false","2926","8.0","2","2","false","0","2926","15236896"
"5.427952850613424","2.928140948047418","0.18423151923417833","0.26666666666666666","10","12","6","false","22275","10.0","6","6","false","0","22275","213935867"
"5.660813086360356","4.13589375019918","0.17665306816250212","0.12727272727272726","11","22","11","false","6023","4.0","11","11","false","0","6023","288941879"
"5.138561462593216","1.2905759583427254","0.19460699405458545","0.4","11","10","5","false","13624","13.8","5","5","false","0","13624","126573775"
"5.711811402453693","0.3267217566508148","0.17507580862533692","0.6666666666666666","11","8","4","false","19682","7.0","4","4","false","0","19682","32530868"
"5.4207361077700265","1.381405727505329","0.18447679062749622","0.3333333333333333","11","6","3","false","17859","8.666666666666666","3","3","false","0","17859","105725698"
"1.0","2.1666666666666665","1.0","0.3333333333333333","1","6","3","false","6075","1.6666666666666667","3","3","false","0","6075","13"
"1.6666666666666667","0.0","0.6","0.0","2","2","1","false","13932","3.0","1","1","false","0","13932","0"
"1.3333333333333333","0.0","0.75","1.0","2","4","2","false","14499","2.5","2","2","false","0","14499","0"
"1.3333333333333333","0.0","0.75","1.0","2","4","2","false","20345","2.5","2","2","false","0","20345","0"
"5.925908106807794","0.23032385755400522","0.168750507428757","0.3333333333333333","13","6","3","false","4023","5.666666666666667","3","3","false","0","4023","18797695"
"6.257156603319702","1.2247596329162194","0.15981700049978856","0.16666666666666666","13","8","4","false","11902","4.75","4","4","false","0","11902","102584847"
"5.5265816694731775","1.7683974180307265","0.18094367545921478","0.26666666666666666","12","12","6","false","13647","7.333333333333333","6","6","false","0","13647","122835033"
"5.901852297329805","0.0","0.16943833048015","1.0","12","6","3","false","19146","9.666666666666666","3","3","false","0","19146","0"
"5.317777243204234","2.3798141880688943","0.18804849362164117","0.3333333333333333","11","12","6","false","22699","10.666666666666666","6","6","false","0","22699","195091442"
"6.295886456579264","0.0","0.15883386825615162","0.0","13","2","1","false","23622","12.0","1","1","false","0","23622","0"
"6.15275439018523","0.0","0.16252883449974587","1.0","13","4","2","false","25057","9.0","2","2","false","0","25057","0"
"7.256916045224922","0.0","0.13779958232505718","0.0","14","2","1","false","11617","4.0","1","1","false","0","11617","0"
"7.256916045224922","0.0","0.13779958232505718","0.0","14","2","1","false","21029","4.0","1","1","false","0","21029","0"
"5.538609574212172","3.1275032695480838","0.18055072967338429","0.1","11","10","5","false","12040","6.4","5","5","false","0","12040","207781970"
"5.311041616550397","17.83331435292182","0.1882869825165323","0.13768115942028986","11","48","24","false","1217","6.625","24","24","false","0","1217","1617924987"
"6.310079384171277","0.0","0.15847661164271282","1.0","12","6","3","false","269","11.333333333333334","3","3","false","0","269","0"
"6.138080346403656","0.0","0.16291738517008936","1.0","11","6","3","false","1150","12.0","3","3","false","0","1150","0"
"6.310319942266057","0.0","0.1584705702958219","1.0","12","6","3","false","1611","11.666666666666666","3","3","false","0","1611","0"
"5.45657926389223","8.117649717480832","0.18326500022042938","0.34615384615384615","12","26","13","false","2165","11.076923076923077","13","13","false","0","2165","777909497"
"6.189559778686553","0.015090520201559356","0.16156237854644384","0.6666666666666666","12","6","3","false","3944","10.0","3","3","false","0","3944","1617210"
"5.692566754871302","1.3232063546233805","0.17566768086544962","0.6","12","10","5","false","5488","9.2","5","5","false","0","5488","115035031"
"5.775559297570363","0.0","0.1731434045566246","1.0","12","12","6","false","6033","14.333333333333334","6","6","false","0","6033","0"
"5.884291556410873","0.8316294177541647","0.16994399247782185","0.5","11","10","5","false","8128","8.6","5","5","false","0","8128","63029005"
"6.309838826076497","1.033644330110534","0.1584826534502478","0.5","12","8","4","false","9974","8.5","4","4","false","0","9974","88106614"
"5.690401732018282","2.0812700252575556","0.17573451701543016","0.6","12","10","5","false","12735","9.6","5","5","false","0","12735","177603256"
"5.407264854462353","10.188817662072616","0.18493638224041284","0.2","11","30","15","false","14430","9.733333333333333","15","15","false","0","14430","1139836181"
"6.307914361318258","5.99623870401468","0.15853100450003815","0.1","12","10","5","false","19877","6.6","5","5","false","0","19877","539466132"
"6.310560500360837","0.0","0.15846452940952235","1.0","12","4","2","false","20495","13.5","2","2","false","0","20495","0"
"6.310319942266057","0.0","0.1584705702958219","1.0","12","6","3","false","21638","11.666666666666666","3","3","false","0","21638","0"
"6.0132306952128936","0.0","0.1662999559947194","1.0","12","6","3","false","21708","17.333333333333332","3","3","false","0","21708","0"
"5.579985566514313","3.601641630272249","0.17921193309191238","0.4222222222222222","11","20","10","false","22242","10.9","10","10","false","0","22242","367609180"
"5.775078181380803","0.22513350102487728","0.17315782896655144","0.6428571428571429","12","16","8","false","23233","11.25","8","8","false","0","23233","26457248"
"5.620880442626895","1.7930688358346214","0.1779080715569631","0.4","10","12","6","false","24126","8.666666666666666","6","6","false","0","24126","225790715"
"6.095261005532836","0.12485177121968138","0.16406188333727997","0.5333333333333333","11","12","6","false","25648","7.5","6","6","false","0","25648","18960339"
"5.2427231176329085","25.542217595136087","0.19074057079930257","0.14624505928853754","11","46","23","false","3501","8.521739130434783","23","23","false","0","3501","2904174928"
"6.432523454414241","0.0","0.15545998504113687","1.0","12","6","3","false","16278","8.0","3","3","false","0","16278","0"
"6.089968727447679","0.5436266349370434","0.16420445568020223","0.38095238095238093","12","14","7","false","24705","8.428571428571429","7","7","false","0","24705","61802416"
"6.7031513110416165","0.0","0.14918356361026378","0.0","13","2","1","false","19355","8.0","1","1","false","0","19355","0"
"5.67452489776281","3.052431529158665","0.17622620713044215","0.35714285714285715","11","16","8","false","22018","9.625","8","8","false","0","22018","244469968"
"6.094298773153716","0.3371477302475534","0.1640877871634957","0.4","12","10","5","false","25660","9.4","5","5","false","0","25660","23679096"
"5.67380322347847","0.0","0.17624862206393624","1.0","12","6","3","false","3312","7.0","3","3","false","0","3312","0"
"5.67380322347847","0.0","0.17624862206393624","1.0","12","6","3","false","11493","7.0","3","3","false","0","11493","0"
"1.5","0.0","0.6666666666666666","0.0","2","2","1","false","5059","2.0","1","1","false","0","5059","0"
"1.0","2.5","1.0","0.0","1","4","2","false","21530","1.0","2","2","false","0","21530","5"
"1.5","0.0","0.6666666666666666","0.0","2","2","1","false","13485","2.0","1","1","false","0","13485","0"
"5.943949963916285","4.050335102751183","0.1682382937391234","0.0","11","4","2","false","11032","7.0","2","2","false","0","11032","304830904"
"6.9422660572528265","3.4533161593221586","0.14404518521085277","0.5","12","8","4","false","10719","2.75","4","4","false","0","10719","260137698"
"5.525619437094059","0.49198008073855853","0.18097518502394427","0.5","11","8","4","false","2200","7.5","4","4","false","0","2200","39428694"
"5.806110175607409","0.711136376112894","0.17223235001657275","0.0","11","4","2","false","17729","8.5","2","2","false","0","17729","42149906"
"5.176088525378879","5.3574980132463335","0.19319607752010037","0.23809523809523808","11","14","7","false","20052","7.142857142857143","7","7","false","0","20052","378899442"
"5.904738994467164","2.4535611164581326","0.16935549580379694","0.3333333333333333","11","6","3","false","21830","5.666666666666667","3","3","false","0","21830","180638247"
"5.585758960789031","0.7618178839864438","0.17902670111972438","0.0","10","4","2","false","379","11.5","2","2","false","0","379","82142606"
"5.576858311282175","0.3611944865860949","0.17931242720959323","0.6","12","12","6","false","6064","7.833333333333333","6","6","false","0","6064","72089750"
"5.576858311282175","0.3611944865860949","0.17931242720959323","0.6","12","12","6","false","9439","7.833333333333333","6","6","false","0","9439","72089750"
"5.656242482559538","0.0","0.17679581508101902","1.0","12","4","2","false","10907","11.5","2","2","false","0","10907","0"
"6.461390425787828","0.0","0.15476545048399107","0.0","11","2","1","false","4638","6.0","1","1","false","0","4638","0"
"6.461390425787828","0.0","0.15476545048399107","0.0","11","2","1","false","23909","6.0","1","1","false","0","23909","0"
"6.919894154438297","0.0","0.14451088090106376","0.0","12","2","1","false","18237","4.0","1","1","false","0","18237","0"
"6.103199422660572","0.23073996239187375","0.16384848843167396","0.0","11","4","2","false","19219","8.5","2","2","false","0","19219","18267569"
"1.0","2.0","1.0","0.0","1","4","2","false","18171","1.0","2","2","false","0","18171","4"
"1.5","0.0","0.6666666666666666","0.0","2","2","1","false","85","2.0","1","1","false","0","85","0"
"1.5","0.0","0.6666666666666666","0.0","2","2","1","false","5413","2.0","1","1","false","0","5413","0"
"5.719749819581429","0.0","0.17483282163435254","0.0","12","2","1","false","8630","12.0","1","1","false","0","8630","0"
"5.688958383449603","2.0539245263447974","0.175779102710474","0.3333333333333333","12","8","4","false","16521","6.25","4","4","false","0","16521","170935479"
"5.689439499639163","0.1522832093459606","0.17576423829859203","0.6666666666666666","12","6","3","false","20517","8.0","3","3","false","0","20517","21113975"
"6.642290113062304","0.0","0.150550485296248","0.0","12","2","1","false","26005","4.0","1","1","false","0","26005","0"
"5.508780370459466","2.369621597371529","0.18152838427947598","0.23809523809523808","11","14","7","false","8774","7.714285714285714","7","7","false","0","8774","251951054"
"4.9699302381525134","10.548270055248546","0.2012100677637948","0.24242424242424243","11","24","12","false","5209","8.916666666666666","12","12","false","0","5209","869688711"
"6.5082992542699065","0.0","0.15364997227869154","1.0","12","4","2","false","6943","4.5","2","2","false","0","6943","0"
"6.5082992542699065","0.0","0.15364997227869154","1.0","12","4","2","false","22748","4.5","2","2","false","0","22748","0"
"4.613904257878278","43.88242627520751","0.2167361835245047","0.11462450592885376","10","46","23","false","24057","9.217391304347826","23","23","false","0","24057","3968478991"
"5.342073610777002","3.9331757805638117","0.18719322736074212","0.2777777777777778","11","18","9","false","25902","7.333333333333333","9","9","false","0","25902","393879620"
"5.851575655520809","0.0","0.1708941418293936","1.0","12","8","4","false","1014","8.75","4","4","false","0","1014","0"
"6.3415924945874425","0.0","0.15768909794401031","1.0","12","4","2","false","12112","5.5","2","2","false","0","12112","0"
"6.3415924945874425","0.0","0.15768909794401031","1.0","12","4","2","false","17440","5.5","2","2","false","0","17440","0"
"5.851575655520809","0.0","0.1708941418293936","1.0","12","8","4","false","19150","8.75","4","4","false","0","19150","0"
"5.433485686793361","1.3910046990748293","0.1840439190684907","0.0","11","4","2","false","21027","15.0","2","2","false","0","21027","178037086"
"6.166466201587683","0.36623170390417314","0.16216743387688226","0.3333333333333333","12","6","3","false","8087","5.0","3","3","false","0","8087","24007279"
"6.341111378397883","0.0","0.157701062215478","1.0","12","4","2","false","15523","5.0","2","2","false","0","15523","0"
"6.341351936492663","0.0","0.15769507985281286","0.0","12","2","1","false","17339","8.0","1","1","false","0","17339","0"
"6.341351936492663","0.0","0.15769507985281286","0.0","12","2","1","false","19711","8.0","1","1","false","0","19711","0"
"6.341111378397883","0.0","0.157701062215478","1.0","12","4","2","false","20307","5.0","2","2","false","0","20307","0"
"1.0","0.0","1.0","0.0","1","2","1","false","1194","1.0","1","1","false","0","1194","0"
"1.0","0.0","1.0","0.0","1","2","1","false","21858","1.0","1","1","false","0","21858","0"
"6.306230454654799","1.155048837460753","0.15857333587640662","0.16666666666666666","12","8","4","false","7829","3.75","4","4","false","0","7829","74293853"
"7.305989896560019","0.0","0.13687399163675876","0.0","13","2","1","false","5360","4.0","1","1","false","0","5360","0"
"7.305989896560019","0.0","0.13687399163675876","0.0","13","2","1","false","19544","4.0","1","1","false","0","19544","0"
"6.560019244647583","3.0435412355062406","0.15243857719105244","0.16666666666666666","12","8","4","false","715","3.25","4","4","false","0","715","205744155"
"6.825114265095021","0.0","0.14651769350063443","0.0","12","2","1","false","16554","5.0","1","1","false","0","16554","0"
"1.5","0.0","0.6666666666666666","0.0","2","2","1","false","4252","2.0","1","1","false","0","4252","0"
"1.0","2.5","1.0","0.0","1","4","2","false","24451","1.0","2","2","false","0","24451","5"
"1.5","0.0","0.6666666666666666","0.0","2","2","1","false","23856","2.0","1","1","false","0","23856","0"
"6.787827760404138","0.0","0.1473225360598221","1.0","12","6","3","false","6095","4.333333333333333","3","3","false","0","6095","0"
"6.787587202309358","0.610131443350884","0.14732775730082223","0.5","12","8","4","false","7446","3.25","4","4","false","0","7446","93035230"
"6.787827760404138","0.0","0.1473225360598221","1.0","12","6","3","false","25236","4.333333333333333","3","3","false","0","25236","0"
"6.919413038248737","0.0","0.14452092893895147","1.0","13","4","2","false","2852","4.0","2","2","false","0","2852","0"
"6.4380562905941785","1.455491682613228","0.15532638343982363","0.23809523809523808","13","14","7","false","12599","4.0","7","7","false","0","12599","119625626"
"5.681741640606206","1.0479652532196095","0.17600237097252214","0.0","12","4","2","false","25056","14.0","2","2","false","0","25056","64561277"
"6.919413038248737","0.0","0.14452092893895147","1.0","13","4","2","false","25721","4.0","2","2","false","0","25721","0"
"7.4019725763771955","0.0","0.13509912252193695","1.0","12","4","2","false","11638","3.0","2","2","false","0","11638","0"
"6.677892711089728","0.0","0.1497478386167147","1.0","12","4","2","false","7246","3.5","2","2","false","0","7246","0"
"6.677892711089728","0.0","0.1497478386167147","1.0","12","4","2","false","17240","3.5","2","2","false","0","17240","0"
"6.678133269184508","0.0","0.1497424444364396","0.0","12","2","1","false","25091","5.0","1","1","false","0","25091","0"
"7.4202549915804665","0.0","0.13476625818582635","0.0","13","2","1","false","13970","5.0","1","1","false","0","13970","0"
"6.143132066394034","0.0","0.16278341230371618","1.0","13","4","2","false","80","8.0","2","2","false","0","80","0"
"6.070964637960067","0.15992516713142657","0.16471846891468875","0.3333333333333333","13","6","3","false","8742","5.666666666666667","3","3","false","0","8742","11824401"
"6.062785662737551","0.0","0.16494068166488118","1.0","13","4","2","false","23063","10.5","2","2","false","0","23063","0"
"6.779889343276401","0.0","0.14749503264263414","0.0","13","2","1","false","19903","7.0","1","1","false","0","19903","0"
"5.780129901371181","2.046515636364611","0.1730064924255036","0.23809523809523808","12","14","7","false","25469","4.428571428571429","7","7","false","0","25469","204279560"
"6.19701707962473","0.0","0.16136795931834944","1.0","13","4","2","false","2851","7.0","2","2","false","0","2851","0"
"5.28313687755593","2.40683495303343","0.1892814862034423","0.23809523809523808","12","14","7","false","11416","14.571428571428571","7","7","false","0","11416","233626281"
"5.992061582872264","0.6453090847526036","0.1668874703922277","0.6666666666666666","12","8","4","false","23751","6.0","4","4","false","0","23751","83324988"
"5.185470291075295","0.8238669877161293","0.19284653924661346","0.5","10","10","5","false","8552","16.0","5","5","false","0","8552","81676853"
"5.552561943709406","0.0","0.180097045316697","0.0","11","2","1","false","1595","23.0","1","1","false","0","1595","0"
"5.552321385614626","0.0","0.18010484814349467","1.0","11","4","2","false","1910","12.5","2","2","false","0","1910","0"
"5.4731777724320425","0.6456420383334687","0.18270921237693388","0.3333333333333333","11","6","3","false","2293","11.333333333333334","3","3","false","0","2293","43648755"
"5.366129420254992","2.4324890832904775","0.1863540592639082","0.2","11","10","5","false","4135","7.6","5","5","false","0","4135","179542217"
"5.552080827519846","1.3001291002826267","0.18011265164644716","0.0","11","4","2","false","4554","12.0","2","2","false","0","4554","102305166"
"5.552321385614626","0.0","0.18010484814349467","1.0","11","4","2","false","9316","12.5","2","2","false","0","9316","0"
"5.365648304065432","1.171319922870454","0.18637076888590004","0.3333333333333333","11","8","4","false","16498","9.25","4","4","false","0","16498","78793841"
"5.552561943709406","0.0","0.180097045316697","0.0","11","2","1","false","17939","23.0","1","1","false","0","17939","0"
"5.318739475583353","0.0","0.18801447308909996","1.0","11","6","3","false","21587","14.0","3","3","false","0","21587","0"
"5.547510223719028","0.0","0.18026104678895105","1.0","11","4","2","false","24160","13.5","2","2","false","0","24160","0"
"5.406062063988453","0.3685846249944665","0.18497752858986338","0.3333333333333333","11","8","4","false","25354","8.25","4","4","false","0","25354","32601019"
"1.0","0.0","1.0","0.0","1","2","1","false","10676","1.0","1","1","false","0","10676","0"
"1.0","0.0","1.0","0.0","1","2","1","false","24961","1.0","1","1","false","0","24961","0"
"5.709886937695454","0.0","0.17513481631277383","1.0","12","6","3","false","8305","11.0","3","3","false","0","8305","0"
"5.753909069040173","0.0","0.17379489109076468","0.0","12","2","1","false","22771","15.0","1","1","false","0","22771","0"
"6.258118835698821","1.8043914227574063","0.1597924274457044","0.5333333333333333","11","12","6","false","1736","5.166666666666667","6","6","false","0","1736","232607293"
"6.280009622323791","0.0","0.15923542480655786","1.0","11","8","4","false","1914","6.5","4","4","false","0","1914","0"
"7.257397161414482","0.0","0.13779044714773442","1.0","12","6","3","false","7586","5.333333333333333","3","3","false","0","7586","0"
"6.279769064229011","0.1820806887516766","0.15924152461214328","0.8","11","10","5","false","14424","5.6","5","5","false","0","14424","52664899"
"6.279769064229011","0.1820806887516766","0.15924152461214328","0.8","11","10","5","false","19462","5.6","5","5","false","0","19462","52664899"
"1.0","0.0","1.0","0.0","1","2","1","false","2569","1.0","1","1","false","0","2569","0"
"1.0","0.0","1.0","0.0","1","2","1","false","5546","1.0","1","1","false","0","5546","0"
"5.887659369737792","0.0","0.16984678243105208","1.0","12","6","3","false","3654","10.0","3","3","false","0","3654","0"
"5.430358431561222","10.07223364745124","0.18414990697262337","0.19047619047619047","11","30","15","false","11557","5.666666666666667","15","15","false","0","11557","691212620"
"6.58648063507337","0.0","0.15182615047479914","0.0","13","2","1","false","14154","6.0","1","1","false","0","14154","0"
"5.131585277844599","20.76143300772469","0.1948715544721545","0.16666666666666666","11","18","9","false","15477","12.555555555555555","9","9","false","0","15477","1936329599"
"6.58648063507337","0.0","0.15182615047479914","0.0","13","2","1","false","15882","6.0","1","1","false","0","15882","0"
"5.541255713254751","3.619953221366795","0.1804645105274582","0.2857142857142857","11","16","8","false","281","5.625","8","8","false","0","281","221181889"
"6.131344719749819","0.0","0.16309635907093536","0.0","12","2","1","false","5241","9.0","1","1","false","0","5241","0"
"5.162857830165985","22.048112234949027","0.19369117510017708","0.358695652173913","10","48","24","false","9471","11.416666666666666","24","24","false","0","9471","1887525614"
"5.639884532114506","35.16818943915382","0.17730859458306675","0.0718954248366013","11","36","18","false","20765","5.777777777777778","18","18","false","0","20765","4642354181"
"6.0928554245850375","0.0","0.1641266582438408","1.0","12","4","2","false","3948","8.5","2","2","false","0","3948","0"
"5.3225884050998316","7.278994138995503","0.18787851396547048","0.17777777777777778","11","20","10","false","4013","6.3","10","10","false","0","4013","569180309"
"5.275198460428194","3.877076562524231","0.1895663276939213","0.17857142857142858","10","16","8","false","25516","7.25","8","8","false","0","25516","309561228"
"5.303584315612221","1.601439754818678","0.18855173039415793","0.3333333333333333","11","6","3","false","25684","47.333333333333336","3","3","false","0","25684","288109248"
"6.289150829925427","1.4398628494719876","0.15900397796817625","0.0","12","4","2","false","546","4.5","2","2","false","0","546","118470916"
"6.2879480394515275","1.0989186635805464","0.15903439305252687","0.4","12","10","5","false","8641","3.8","5","5","false","0","8641","181032282"
"6.2879480394515275","1.0989186635805464","0.15903439305252687","0.4","12","10","5","false","19922","3.8","5","5","false","0","19922","181032282"
"1.0","2.0","1.0","0.0","1","4","2","false","23175","1.0","2","2","false","0","23175","4"
"1.5","0.0","0.6666666666666666","0.0","2","2","1","false","21206","2.0","1","1","false","0","21206","0"
"1.5","0.0","0.6666666666666666","0.0","2","2","1","false","25662","2.0","1","1","false","0","25662","0"
"6.660331970170796","0.0","0.15014266623325026","1.0","12","4","2","false","887","7.0","2","2","false","0","887","0"
"6.524176088525379","0.0","0.153276059142362","1.0","11","4","2","false","3721","8.5","2","2","false","0","3721","0"
"6.660091412076016","1.1894775860747656E-5","0.15014808928700427","0.6666666666666666","12","6","3","false","9634","5.0","3","3","false","0","9634","411"
"5.9689680057733945","0.0","0.16753314794664087","1.0","11","4","2","false","14781","10.5","2","2","false","0","14781","0"
"6.660572528265576","0.0","0.15013724357122218","0.0","12","2","1","false","18972","11.0","1","1","false","0","18972","0"
"6.660331970170796","0.0","0.15014266623325026","1.0","12","4","2","false","25321","7.0","2","2","false","0","25321","0"
"5.82583593937936","5.3947606124263014","0.17164918655545464","0.3333333333333333","11","6","3","false","8074","8.333333333333334","3","3","false","0","8074","396322597"
"5.058936733221073","2.807126766455405","0.19766999524488824","0.5384615384615384","10","26","13","false","13164","26.846153846153847","13","13","false","0","13164","455117607"
"5.830887659369738","0.0","0.17150047444201494","1.0","11","4","2","false","14541","10.0","2","2","false","0","14541","0"
"5.833774356507097","0.0","0.17141561172735145","1.0","11","4","2","false","15127","9.5","2","2","false","0","15127","0"
"5.833774356507097","0.0","0.17141561172735145","1.0","11","4","2","false","18524","9.5","2","2","false","0","18524","0"
"6.744767861438538","0.0","0.14826307154575932","0.0","13","2","1","false","16230","3.0","1","1","false","0","16230","0"
"5.745008419533317","0.5466462751813272","0.17406414873126205","0.3333333333333333","12","6","3","false","20702","6.333333333333333","3","3","false","0","20702","48677036"
"5.6235265816694735","5.162599183920425","0.1778243572742439","0.3333333333333333","12","6","3","false","25225","9.333333333333334","3","3","false","0","25225","385222489"
"6.2694250661534765","0.0","0.1595042590745146","1.0","13","4","2","false","70","4.5","2","2","false","0","70","0"
"6.268943949963917","1.0891832670660224","0.15951650038372986","0.16666666666666666","13","8","4","false","4727","2.25","4","4","false","0","4727","75367456"
"5.2703872985325955","3.2673857632672187","0.18973937651193573","0.2","12","10","5","false","15559","6.4","5","5","false","0","15559","226112622"
"7.268703391869137","0.0","0.13757611861265553","0.0","14","2","1","false","123","4.0","1","1","false","0","123","0"
"7.268703391869137","0.0","0.13757611861265553","0.0","14","2","1","false","23240","4.0","1","1","false","0","23240","0"
"6.2699061823430355","0.0","0.15949201964395335","1.0","13","4","2","false","3980","3.5","2","2","false","0","3980","0"
"6.2699061823430355","0.0","0.15949201964395335","1.0","13","4","2","false","16962","3.5","2","2","false","0","16962","0"
"7.242242001443349","0.0","0.1380787882814057","0.0","13","2","1","false","3821","6.0","1","1","false","0","3821","0"
"6.558816454173683","0.0","0.15246653218411885","1.0","12","4","2","false","17991","5.5","2","2","false","0","17991","0"
"6.242001443348569","0.0","0.16020502543548637","0.0","11","2","1","false","3875","6.0","1","1","false","0","3875","0"
"1.0","0.0","1.0","0.0","1","2","1","false","9094","1.0","1","1","false","0","9094","0"
"1.0","0.0","1.0","0.0","1","2","1","false","19061","1.0","1","1","false","0","19061","0"
"5.9954293961991825","0.5411159858147129","0.16679372467198972","0.0","11","4","2","false","2080","7.0","2","2","false","0","2080","34287355"
"6.9951888381044025","0.0","0.14295539736579663","0.0","12","2","1","false","4069","2.0","1","1","false","0","4069","0"
"4.9961510704835215","15.287302038877177","0.20015407578602726","0.11538461538461539","10","26","13","false","5385","7.846153846153846","13","13","false","0","5385","1322368382"
"6.927351455376473","0.0","0.14435531478973504","0.0","12","2","1","false","1968","6.0","1","1","false","0","1968","0"
"5.927592013471253","4.783492404514522","0.16870256888924962","0.13333333333333333","11","12","6","false","9082","8.5","6","6","false","0","9082","645544260"
"5.052441664662016","9.314926184336901","0.1979241060800838","0.16363636363636364","10","22","11","false","9306","7.909090909090909","11","11","false","0","9306","960356663"
"6.927351455376473","0.0","0.14435531478973504","0.0","12","2","1","false","15942","6.0","1","1","false","0","15942","0"
"4.452730334375752","24.71367892502053","0.22458130740140464","0.15204678362573099","11","38","19","false","1588","12.578947368421053","19","19","false","0","1588","2749691758"
"5.273033437575174","0.0","0.18964416058394162","1.0","12","4","2","false","2805","13.0","2","2","false","0","2805","0"
"4.793120038489295","3.9902175794073393","0.2086323713927227","0.5","11","10","5","false","8063","19.8","5","5","false","0","8063","283423605"
"5.273273995669954","0.0","0.18963550932895398","0.0","12","2","1","false","9419","22.0","1","1","false","0","9419","0"
"5.8713014192927595","0.0","0.17031999016675542","0.0","11","2","1","false","5827","35.0","1","1","false","0","5827","0"
"5.52056771710368","0.0","0.18114079044838557","1.0","10","6","3","false","6351","16.333333333333332","3","3","false","0","6351","0"
"5.8713014192927595","0.0","0.17031999016675542","0.0","11","2","1","false","6527","35.0","1","1","false","0","6527","0"
"5.8713014192927595","0.0","0.17031999016675542","0.0","11","2","1","false","10881","35.0","1","1","false","0","10881","0"
"5.882607649747414","0.0","0.16999263924102395","1.0","11","8","4","false","5367","6.25","4","4","false","0","5367","0"
"5.882607649747414","0.0","0.16999263924102395","1.0","11","8","4","false","14983","6.25","4","4","false","0","14983","0"
"5.882607649747414","0.0","0.16999263924102395","1.0","11","8","4","false","19144","6.25","4","4","false","0","19144","0"
"6.228530190040895","1.110473357034971","0.1605515217055461","0.38095238095238093","11","14","7","false","24183","6.428571428571429","7","7","false","0","24183","102277904"
"6.9425066153476065","0.0","0.14404019404019405","1.0","11","6","3","false","2184","6.666666666666667","3","3","false","0","2184","0"
"6.165263411113784","1.5015522114744624","0.16219907136446993","0.2857142857142857","11","14","7","false","3193","6.428571428571429","7","7","false","0","3193","133652500"
"6.229732980514794","1.197641062523373","0.1605205236127737","0.3333333333333333","11","12","6","false","4371","6.666666666666667","6","6","false","0","4371","105876379"
"6.230695212893914","1.2795199872184642","0.16049573375545345","0.26666666666666666","11","12","6","false","15998","5.833333333333333","6","6","false","0","15998","94363914"
"7.228289631946115","0.0","0.13834531416400425","0.0","12","2","1","false","23866","7.0","1","1","false","0","23866","0"
"6.366129420254992","1.1473652733707937","0.15708131801692865","0.38095238095238093","11","14","7","false","26004","6.285714285714286","7","7","false","0","26004","136133767"
"6.503969208563868","0.0","0.1537522654140622","0.0","12","2","1","false","11822","6.0","1","1","false","0","11822","0"
"6.503969208563868","0.0","0.1537522654140622","0.0","12","2","1","false","21016","6.0","1","1","false","0","21016","0"
"6.503969208563868","0.0","0.1537522654140622","0.0","12","2","1","false","21169","6.0","1","1","false","0","21169","0"
"5.828482078421939","0.0","0.17157125758388705","0.0","11","2","1","false","2936","15.0","1","1","false","0","2936","0"
"5.828482078421939","0.0","0.17157125758388705","0.0","11","2","1","false","10354","15.0","1","1","false","0","10354","0"
"5.828241520327159","0.0","0.1715783391117715","1.0","11","4","2","false","18905","8.5","2","2","false","0","18905","0"
"5.828241520327159","0.0","0.1715783391117715","1.0","11","4","2","false","21563","8.5","2","2","false","0","21563","0"
"6.295886456579264","0.0","0.15883386825615162","0.0","12","2","1","false","15198","13.0","1","1","false","0","15198","0"
"6.295886456579264","0.0","0.15883386825615162","0.0","12","2","1","false","18067","13.0","1","1","false","0","18067","0"
"5.7207120519605485","2.594754138307456","0.1748034144905597","0.13333333333333333","12","12","6","false","18297","7.166666666666667","6","6","false","0","18297","287783364"
"5.899446716382006","6.378618048898984","0.1695074213015821","0.07142857142857142","12","16","8","false","19781","4.25","8","8","false","0","19781","479631171"
"7.0938176569641564","0.0","0.14096781850859644","0.0","13","2","1","false","10186","3.0","1","1","false","0","10186","0"
"5.952850613423141","0.0","0.167986745332579","0.0","12","2","1","false","1327","7.0","1","1","false","0","1327","0"
"5.952850613423141","0.0","0.167986745332579","0.0","12","2","1","false","6738","7.0","1","1","false","0","6738","0"
"5.421938898243926","0.0","0.1844358667199077","1.0","11","4","2","false","10825","9.5","2","2","false","0","10825","0"
"5.952850613423141","0.0","0.167986745332579","0.0","12","2","1","false","25863","7.0","1","1","false","0","25863","0"
"5.576858311282175","0.0","0.17931242720959323","0.0","11","2","1","false","4382","46.0","1","1","false","0","4382","0"
"5.418330526822228","2.5163698601598403","0.1845586929497425","0.3","12","10","5","false","2789","13.8","5","5","false","0","2789","359390111"
"5.681019966321867","0.0","0.17602472899728996","0.0","12","2","1","false","6641","23.0","1","1","false","0","6641","0"
"5.581428915082992","0.0","0.17916558917334713","1.0","12","4","2","false","15920","16.0","2","2","false","0","15920","0"
"5.5171999037767625","0.033632887079729654","0.18125136254632657","0.6666666666666666","12","6","3","false","18233","12.666666666666666","3","3","false","0","18233","4117654"
"5.680779408227087","0.0","0.17603218293457548","1.0","12","4","2","false","24582","15.0","2","2","false","0","24582","0"
"5.681019966321867","0.0","0.17602472899728996","0.0","12","2","1","false","24583","23.0","1","1","false","0","24583","0"
"6.484724560981477","33.360044967462144","0.15420855436435804","0.8466666666666667","12","50","25","false","6583","21.76","25","25","false","0","6583","2960937721"
"6.495309117151792","0.0","0.15395726084219102","1.0","12","4","2","false","15960","9.5","2","2","false","0","15960","0"
"6.495790233341352","0.0","0.15394585786764434","1.0","12","4","2","false","15974","7.0","2","2","false","0","15974","0"
"6.496271349530912","0.0","0.1539344565821144","0.0","12","2","1","false","17564","10.0","1","1","false","0","17564","0"
"6.488814048592735","0.4817998328788923","0.15411136650107513","0.4","12","10","5","false","18782","10.0","5","5","false","0","18782","126350697"
"6.495309117151792","0.2303987575525618","0.15395726084219102","0.5","12","8","4","false","23883","4.75","4","4","false","0","23883","62804552"
"5.401010343998076","2.5927640332174593","0.18515054338143594","0.26666666666666666","11","12","6","false","14033","7.5","6","6","false","0","14033","315007444"
"5.929275920134713","0.0","0.1686546575787082","0.0","12","2","1","false","25383","13.0","1","1","false","0","25383","0"
"5.4207361077700265","0.56878389000476","0.18447679062749622","0.3333333333333333","11","8","4","false","22197","21.25","4","4","false","0","22197","102135867"
"5.080346403656483","0.2368546163711114","0.19683697144751172","0.3333333333333333","11","8","4","false","9255","18.5","4","4","false","0","9255","65430240"
"5.277604041375993","0.0","0.1894799216008022","1.0","12","4","2","false","20065","15.0","2","2","false","0","20065","0"
"4.8537406783738275","9.489757444348935","0.20602666402339295","0.2545454545454545","11","22","11","false","22917","13.909090909090908","11","11","false","0","22917","1195724086"
"5.294924224200145","0.0","0.18886011539684702","0.0","12","2","1","false","23910","26.0","1","1","false","0","23910","0"
"5.175847967284099","0.0","0.1932050567019892","1.0","11","4","2","false","25572","29.5","2","2","false","0","25572","0"
"5.171999037767621","5.94522360210626","0.19334883720930235","0.2777777777777778","11","18","9","false","25582","9.222222222222221","9","9","false","0","25582","710772838"
"5.362761606928073","0.0","0.1864710895796887","1.0","11","8","4","false","193","15.5","4","4","false","0","193","0"
"5.217945633870579","0.38309646094303956","0.19164630491909088","0.6666666666666666","11","8","4","false","9993","20.0","4","4","false","0","9993","89038448"
"5.362761606928073","0.0","0.1864710895796887","1.0","11","8","4","false","10819","15.5","4","4","false","0","10819","0"
"5.342314168871782","8.729498796721328","0.18718479827089338","0.4666666666666667","11","12","6","false","11231","11.0","6","6","false","0","11231","717860397"
"5.343035843156122","0.0","0.18715951555535545","1.0","11","6","3","false","12149","19.333333333333332","3","3","false","0","12149","0"
"5.3492903536203995","1.4004299121452093","0.18694068444484419","0.2","11","12","6","false","20129","10.0","6","6","false","0","20129","159397512"
"5.327880683184989","11.12525480650144","0.1876918909156583","0.38461538461538464","11","28","14","false","23114","9.714285714285714","14","14","false","0","23114","1196572327"
"6.230454654799134","0.0","0.1605019305019305","1.0","12","4","2","false","4878","9.5","2","2","false","0","4878","0"
"6.230695212893914","0.0","0.16049573375545345","1.0","12","6","3","false","5184","7.0","3","3","false","0","5184","0"
"6.230695212893914","0.0","0.16049573375545345","1.0","12","6","3","false","8643","7.0","3","3","false","0","8643","0"
"6.229973538609574","1.94951104657126","0.16051432543053518","0.3333333333333333","12","8","4","false","11967","5.25","4","4","false","0","11967","133808524"
"6.230695212893914","0.0","0.16049573375545345","1.0","12","6","3","false","21779","7.0","3","3","false","0","21779","0"
"6.230935770988694","0.0","0.1604895374874527","1.0","12","4","2","false","24503","8.5","2","2","false","0","24503","0"
"6.230935770988694","0.0","0.1604895374874527","1.0","12","4","2","false","24942","8.5","2","2","false","0","24942","0"
"1.0","0.0","1.0","0.0","1","2","1","false","2119","1.0","1","1","false","0","2119","0"
"1.0","0.0","1.0","0.0","1","2","1","false","7637","1.0","1","1","false","0","7637","0"
"6.625691604522492","1.0452693304348195","0.15092764041680282","0.2","13","10","5","false","11442","4.0","5","5","false","0","11442","84950197"
"6.8359393793601155","0.0","0.14628567406833937","1.0","13","4","2","false","13651","4.5","2","2","false","0","13651","0"
"6.23935530430599","0.0","0.16027296911747696","1.0","11","4","2","false","81","7.5","2","2","false","0","81","0"
"6.728650469088285","0.0","0.1486182117192807","1.0","12","4","2","false","1029","7.5","2","2","false","0","1029","0"
"6.728891027183065","0.0","0.14861289861289861","0.0","12","2","1","false","3819","10.0","1","1","false","0","3819","0"
"5.407505412557133","0.0","0.18492815516704478","1.0","11","10","5","false","869","18.6","5","5","false","0","869","0"
"5.052201106567236","5.396545981321635","0.19793353013998666","0.24358974358974358","10","26","13","false","3618","11.461538461538462","13","13","false","0","3618","641895448"
"5.352898725042098","0.10104443084908983","0.18681466834441846","0.7333333333333333","11","12","6","false","14709","16.666666666666668","6","6","false","0","14709","18551789"
"5.923021409670436","2.897967288774248","0.1688327511981155","0.2857142857142857","11","16","8","false","122","6.375","8","8","false","0","122","211235588"
"6.031753668510945","0.0","0.16578926377921352","1.0","11","6","3","false","6530","10.333333333333334","3","3","false","0","6530","0"
"6.031753668510945","0.0","0.16578926377921352","1.0","11","6","3","false","6707","10.333333333333334","3","3","false","0","6707","0"
"6.029588645657927","0.0","0.1658487931378416","1.0","11","6","3","false","6911","12.0","3","3","false","0","6911","0"
"5.56507096463796","0.0","0.17969222788968617","1.0","11","6","3","false","15479","17.666666666666668","3","3","false","0","15479","0"
"6.830165985085398","0.6568063701820948","0.14640932624238367","0.0","12","4","2","false","3524","3.5","2","2","false","0","3524","91309182"
"5.840028866971374","1.3192964370947593","0.1712320303167607","0.3333333333333333","12","8","4","false","19927","6.5","4","4","false","0","19927","93933119"
"6.224681260524417","1.038471930528489","0.16065079610449837","0.0","12","6","3","false","19350","2.3333333333333335","3","3","false","0","19350","90353418"
"6.2256434929035365","0.0","0.16062596599690881","0.0","12","2","1","false","25959","5.0","1","1","false","0","25959","0"
"6.418089968727448","0.0","0.1558095952023988","0.0","13","2","1","false","7281","5.0","1","1","false","0","7281","0"
"5.737791676689921","0.0","0.17428307898708703","1.0","12","6","3","false","25597","15.666666666666666","3","3","false","0","25597","0"
"5.211931681501082","6.931376848128756","0.19186744207514078","0.2","11","12","6","false","727","9.333333333333334","6","6","false","0","727","518520035"
"5.041135434207361","18.5893213158987","0.19836800916205383","0.10606060606060606","11","24","12","false","8471","7.25","12","12","false","0","8471","1509303970"
"5.2177050757757995","0.0","0.19165514061779623","1.0","11","6","3","false","16649","19.666666666666668","3","3","false","0","16649","0"
"5.052201106567236","10.367171982000887","0.19793353013998666","0.15151515151515152","10","24","12","false","18331","11.333333333333334","12","12","false","0","18331","961093346"
"5.398604763050277","0.0","0.18523304518313874","1.0","11","4","2","false","19469","18.5","2","2","false","0","19469","0"
"7.218907866249699","0.0","0.1385251091339265","0.0","12","2","1","false","1105","4.0","1","1","false","0","1105","0"
"7.218907866249699","0.0","0.1385251091339265","0.0","12","2","1","false","14985","4.0","1","1","false","0","14985","0"
"4.733461630983882","6.486540684635824","0.21126187935152718","0.16483516483516483","10","28","14","false","17911","10.571428571428571","14","14","false","0","17911","739907363"
"4.817175847967284","2.804533257485329","0.2075905118601748","0.32142857142857145","11","16","8","false","26127","13.625","8","8","false","0","26127","361557499"
"6.3480875631465","0.0","0.157527757777862","1.0","12","4","2","false","20215","7.5","2","2","false","0","20215","0"
"6.3480875631465","0.0","0.157527757777862","1.0","12","4","2","false","21333","7.5","2","2","false","0","21333","0"
"7.003127255232139","0.0","0.1427933498213795","0.0","12","2","1","false","18625","4.0","1","1","false","0","18625","0"
"6.115467885494347","1.476194299166752","0.16351978601211548","0.3333333333333333","12","6","3","false","7584","6.666666666666667","3","3","false","0","7584","127452233"
"6.115708443589127","0.0","0.16351335404948275","1.0","12","6","3","false","12049","7.333333333333333","3","3","false","0","12049","0"
"6.237430839547751","0.0","0.160322418913186","1.0","12","4","2","false","12763","11.0","2","2","false","0","12763","0"
"6.115708443589127","0.0","0.16351335404948275","1.0","12","6","3","false","17382","7.333333333333333","3","3","false","0","17382","0"
"7.248737070002406","1.4814858826664579","0.1379550658746225","0.0","12","4","2","false","408","3.5","2","2","false","0","408","103783307"
"8.248496511907625","0.0","0.12123421505439064","0.0","13","2","1","false","13834","2.0","1","1","false","0","13834","0"
"6.249458744286745","12.03029694917232","0.16001385734631818","0.13333333333333333","11","12","6","false","17149","4.5","6","6","false","0","17149","843655275"
"6.863844118354582","0.0","0.14569095433357868","0.0","12","2","1","false","23267","2.0","1","1","false","0","23267","0"
"7.374548953572288","1.477878900415663","0.13560151356993738","0.3333333333333333","13","6","3","false","5843","2.3333333333333335","3","3","false","0","5843","95177264"
"7.373827279287948","1.6934944316241978","0.13561478484977002","0.0","13","6","3","false","11213","2.3333333333333335","3","3","false","0","11213","109006519"
"7.374789511667068","0.0","0.13559709038718726","1.0","13","4","2","false","25877","3.5","2","2","false","0","25877","0"
"8.374308395477508","0.0","0.11941284614500747","0.0","14","2","1","false","5361","3.0","1","1","false","0","5361","0"
"7.115227327399567","0.0","0.1405436473054297","0.0","13","2","1","false","18097","3.0","1","1","false","0","18097","0"
"6.223478470050517","9.364169531639258E-5","0.16068184453635345","0.9333333333333333","12","12","6","false","272","9.833333333333334","6","6","false","0","272","8089"
"5.4909790714457545","17.564339254712802","0.18211688425479716","0.20261437908496732","11","36","18","false","2912","8.222222222222221","18","18","false","0","2912","1555739840"
"6.223478470050517","9.364169531639258E-5","0.16068184453635345","0.9333333333333333","12","12","6","false","11811","9.833333333333334","6","6","false","0","11811","8089"
"6.223478470050517","9.364169531639258E-5","0.16068184453635345","0.9333333333333333","12","12","6","false","11840","9.833333333333334","6","6","false","0","11840","8089"
"6.223719028145297","0.0","0.16067563388991962","1.0","12","10","5","false","19012","11.0","5","5","false","0","19012","0"
"6.223719028145297","0.0","0.16067563388991962","1.0","12","10","5","false","20305","11.0","5","5","false","0","20305","0"
"5.60909309598268","0.1796745250855793","0.17828194021529356","0.47619047619047616","11","14","7","false","4483","10.142857142857142","7","7","false","0","4483","21496526"
"5.80514794322829","0.0","0.17226089839217634","1.0","11","6","3","false","6175","19.0","3","3","false","0","6175","0"
"6.193168150108251","0.0","0.16146824626141","1.0","12","6","3","false","6266","14.666666666666666","3","3","false","0","6266","0"
"6.224200144334857","0.0","0.16066321403725747","1.0","12","6","3","false","8215","15.666666666666666","3","3","false","0","8215","0"
"6.4907385133509745","0.0","0.15406567341190422","0.0","12","2","1","false","8310","18.0","1","1","false","0","8310","0"
"6.489295164782295","1.603340539271514","0.154099940688019","0.5","12","8","4","false","21401","6.75","4","4","false","0","21401","133027827"
"5.404378157324994","11.365278954091107","0.18503516424819727","0.2222222222222222","11","20","10","false","4673","6.8","10","10","false","0","4673","2288070724"
"6.012990137118114","0.944848113941695","0.1663066090574492","0.5333333333333333","12","12","6","false","7475","10.5","6","6","false","0","7475","360149462"
"6.592013471253308","2.334233940547653","0.1516987191183447","0.0","12","6","3","false","11426","7.0","3","3","false","0","11426","218670713"
"6.592735145537647","0.0","0.15168211340582355","1.0","12","4","2","false","23673","12.5","2","2","false","0","23673","0"
"6.357469328842916","4.032541667442037","0.1572952928711972","0.32142857142857145","12","16","8","false","26088","7.875","8","8","false","0","26088","671594706"
"5.343757517440462","6.9250179655837245","0.1871342396686774","0.03571428571428571","11","16","8","false","2797","5.625","8","8","false","0","2797","485172295"
"6.0300697618474866","0.0","0.16583556069733113","0.0","12","2","1","false","9314","9.0","1","1","false","0","9314","0"
"6.0300697618474866","0.0","0.16583556069733113","0.0","12","2","1","false","12291","9.0","1","1","false","0","12291","0"
"5.686312244407024","0.0","0.17586090193755816","1.0","11","4","2","false","12639","9.0","2","2","false","0","12639","0"
"6.0300697618474866","0.0","0.16583556069733113","0.0","12","2","1","false","13292","9.0","1","1","false","0","13292","0"
"6.0300697618474866","0.0","0.16583556069733113","0.0","12","2","1","false","13320","9.0","1","1","false","0","13320","0"
"6.505412557132548","0.703235124352791","0.15371815257183005","0.0","12","4","2","false","12664","2.5","2","2","false","0","12664","49095290"
"5.766899206158287","0.0","0.17340341217202687","1.0","11","6","3","false","1109","8.666666666666666","3","3","false","0","1109","0"
"5.7036324272311765","0.0","0.17532686630113875","1.0","11","6","3","false","9126","19.333333333333332","3","3","false","0","9126","0"
"5.766899206158287","0.0","0.17340341217202687","1.0","11","6","3","false","10655","8.666666666666666","3","3","false","0","10655","0"
"5.7036324272311765","0.0","0.17532686630113875","1.0","11","6","3","false","11610","19.333333333333332","3","3","false","0","11610","0"
"5.706519124368535","1.0909593608966432","0.17523817553326027","0.5","11","8","4","false","12742","9.0","4","4","false","0","12742","83553512"
"5.792638922299735","0.0","0.17263289036544852","0.0","11","2","1","false","18445","19.0","1","1","false","0","18445","0"
"5.887659369737792","0.0","0.16984678243105208","0.0","11","2","1","false","4052","9.0","1","1","false","0","4052","0"
"5.226846283377435","0.0","0.1913199558173785","1.0","10","6","3","false","195","12.0","3","3","false","0","195","0"
"5.545826317055569","0.0","0.18031578034180618","1.0","10","4","2","false","17208","10.5","2","2","false","0","17208","0"
"5.226846283377435","0.0","0.1913199558173785","1.0","10","6","3","false","19168","12.0","3","3","false","0","19168","0"
"4.800577339427472","0.9363135961350549","0.20830827821206654","0.6","10","10","5","false","20119","16.4","5","5","false","0","20119","131800324"
"5.545826317055569","0.0","0.18031578034180618","1.0","10","4","2","false","21929","10.5","2","2","false","0","21929","0"
"6.074091893192206","0.0","0.16463366336633664","0.0","12","2","1","false","17589","11.0","1","1","false","0","17589","0"
"6.430358431561222","0.0","0.1555123265122891","1.0","12","6","3","false","6533","8.0","3","3","false","0","6533","0"
"6.107288910271831","0.23227123212721512","0.16373877422404284","0.6","12","10","5","false","8155","8.8","5","5","false","0","8155","29474128"
"5.515275439018523","3.346972200599108","0.18131460723164827","0.35714285714285715","11","16","8","false","14165","15.0","8","8","false","0","14165","433771708"
"6.430358431561222","0.0","0.1555123265122891","1.0","12","6","3","false","24204","8.0","3","3","false","0","24204","0"
"6.230695212893914","0.0","0.16049573375545345","1.0","12","4","2","false","25911","14.5","2","2","false","0","25911","0"
"6.541736829444311","0.005666784542931882","0.15286460248584247","0.3333333333333333","12","6","3","false","24506","6.333333333333333","3","3","false","0","24506","856051"
"6.5792638922299735","0.0","0.1519926873857404","1.0","12","4","2","false","24595","6.5","2","2","false","0","24595","0"
"6.654799133990859","0.0","0.1502674956622325","1.0","13","4","2","false","9483","7.0","2","2","false","0","9483","0"
"5.705075775799855","2.953970165788913","0.1752825096980941","0.23809523809523808","12","14","7","false","25250","5.142857142857143","7","7","false","0","25250","219404942"
"6.294443108010585","0.9258171829755572","0.15887028968890926","0.5","13","8","4","false","1258","5.75","4","4","false","0","1258","89738891"
"6.203993264373346","1.0880298573196754","0.1611865063978286","0.4","13","10","5","false","12032","5.8","5","5","false","0","12032","115499155"
"7.095501563627616","0.0","0.14093436398155681","1.0","14","4","2","false","12797","5.5","2","2","false","0","12797","0"
"7.095501563627616","0.0","0.14093436398155681","1.0","14","4","2","false","21584","6.0","2","2","false","0","21584","0"
"5.625451046427712","2.1339265958867966","0.17776352362625614","0.4","12","12","6","false","6434","8.5","6","6","false","0","6434","144441989"
"5.386576858311282","2.106164404302144","0.18564665952125758","0.4","11","10","5","false","21162","9.8","5","5","false","0","21162","163505295"
"6.414481597305749","0.0","0.1558972435777236","1.0","13","6","3","false","10879","4.666666666666667","3","3","false","0","10879","0"
"6.414481597305749","0.0","0.1558972435777236","1.0","13","6","3","false","11925","4.666666666666667","3","3","false","0","11925","0"
"6.414481597305749","0.0","0.1558972435777236","1.0","13","6","3","false","15082","4.666666666666667","3","3","false","0","15082","0"
"6.401010343998076","0.7230699214253716","0.15622533729189372","0.0","13","4","2","false","18595","6.0","2","2","false","0","18595","55363528"
"7.548472456098148","0.0","0.13247713438924122","0.0","14","2","1","false","8787","2.0","1","1","false","0","8787","0"
"5.936252104883329","0.3723031186961718","0.16845645742999554","0.3333333333333333","12","6","3","false","11979","6.333333333333333","3","3","false","0","11979","27066396"
"5.15299494828001","0.13090121279690223","0.19406190187199476","0.6","11","10","5","false","16274","15.6","5","5","false","0","16274","21218762"
"5.4996391628578305","0.0","0.18183011110139094","1.0","12","4","2","false","22722","17.0","2","2","false","0","22722","0"
"6.295886456579264","0.0","0.15883386825615162","0.0","12","2","1","false","183","5.0","1","1","false","0","183","0"
"5.9959105123887415","0.0","0.1667803410230692","0.0","11","2","1","false","3982","13.0","1","1","false","0","3982","0"
"5.983882607649748","6.931738906771116","0.16711557788944723","0.5333333333333333","11","20","10","false","9090","7.8","10","10","false","0","9090","759039712"
"5.504690882848208","1.4893925943212885","0.1816632434558406","0.6666666666666666","11","8","4","false","17543","9.5","4","4","false","0","17543","176414584"
"5.807312966081309","0.655624648800231","0.17219667785095893","0.5","11","8","4","false","18723","5.25","4","4","false","0","18723","47927525"
"5.807553524176089","0.0","0.17218954519095353","1.0","11","6","3","false","21090","7.0","3","3","false","0","21090","0"
"5.894635554486409","0.2672634813250476","0.16964577211883772","0.6666666666666666","11","8","4","false","24589","7.75","4","4","false","0","24589","29148635"
"5.388501323069521","0.18782055599668634","0.18558035714285714","0.6666666666666666","10","6","3","false","23145","12.666666666666666","3","3","false","0","23145","23295379"
"5.770507577579986","0.0","0.1732949808237452","0.0","10","2","1","false","7573","12.0","1","1","false","0","7573","0"
"5.770507577579986","0.0","0.1732949808237452","0.0","10","2","1","false","8193","12.0","1","1","false","0","8193","0"
"5.770507577579986","0.0","0.1732949808237452","0.0","10","2","1","false","16576","12.0","1","1","false","0","16576","0"
"5.770507577579986","0.0","0.1732949808237452","0.0","10","2","1","false","16889","12.0","1","1","false","0","16889","0"
"5.502525859995189","0.4572267536745531","0.1817347206435254","0.3333333333333333","10","6","3","false","18521","6.666666666666667","3","3","false","0","18521","38774176"
"5.644695694010103","0.0","0.17715746857021097","1.0","10","4","2","false","21391","11.5","2","2","false","0","21391","0"
"6.144094298773154","0.9640048324060289","0.16275791864061706","0.42857142857142855","11","14","7","false","244","5.857142857142857","7","7","false","0","244","86389651"
"6.442626894394996","0.06090433813604773","0.15521618997834366","0.8333333333333334","11","8","4","false","1353","6.5","4","4","false","0","1353","11318352"
"6.708684147221554","0.0","0.14906052782558807","1.0","12","6","3","false","3286","6.666666666666667","3","3","false","0","3286","0"
"5.679817175847967","2.7985863645375555","0.17606200499767058","0.38095238095238093","11","14","7","false","4765","7.285714285714286","7","7","false","0","4765","296182951"
"6.248015395718066","0.0","0.16005082200746928","1.0","11","6","3","false","16900","7.333333333333333","3","3","false","0","16900","0"
"5.89078662496993","4.455545622615376","0.16975661548513557","0.19444444444444445","11","18","9","false","18030","3.888888888888889","9","9","false","0","18030","333520687"
"6.248015395718066","0.0","0.16005082200746928","1.0","11","6","3","false","22246","7.333333333333333","3","3","false","0","22246","0"
"6.248255953812846","0.0","0.16004466004466003","1.0","11","6","3","false","3752","7.333333333333333","3","3","false","0","3752","0"
"6.201106567235987","1.2943105235487489","0.1612615408487858","0.0","11","4","2","false","4650","8.5","2","2","false","0","4650","84382434"
"5.562665383690161","3.6560438460978433","0.17976993599723232","0.1","11","10","5","false","15971","7.8","5","5","false","0","15971","224278778"
"6.248255953812846","0.0","0.16004466004466003","1.0","11","6","3","false","24174","7.333333333333333","3","3","false","0","24174","0"
"5.558816454173683","2.793128330626205","0.17989440886273153","0.0","11","8","4","false","16765","5.25","4","4","false","0","16765","227789283"
"6.064710127495791","0.0","0.16488834239022648","0.0","11","2","1","false","17017","10.0","1","1","false","0","17017","0"
"5.7305749338465235","0.0","0.17450256065821512","1.0","10","4","2","false","17161","11.0","2","2","false","0","17161","0"
"9.650709646379601","1.395407470451756","0.10361932299715837","0.3333333333333333","16","6","3","false","8925","3.6666666666666665","3","3","false","0","8925","203733138"
"8.65215299494828","6.999246114315336","0.11557816887702617","0.3","15","10","5","false","16505","4.0","5","5","false","0","16505","1020708051"
"10.65046908828482","0.0","0.09389257803677102","0.0","17","2","1","false","20255","3.0","1","1","false","0","20255","0"
"9.650228530190041","1.8821028308293142","0.10362448898195233","0.3","16","10","5","false","21450","2.8","5","5","false","0","21450","273219063"
"6.032475342795285","11.189553763013743","0.16576943015512222","0.14285714285714285","13","16","8","false","3743","4.25","8","8","false","0","3743","973087717"
"6.574212172239596","0.0","0.1521094807713418","1.0","13","4","2","false","839","6.0","2","2","false","0","839","0"
"5.715660331970171","4.619723394548907","0.17495791245791245","0.2","12","10","5","false","2394","6.0","5","5","false","0","2394","486402359"
"5.754630743324513","4.132746750051292","0.17377309589499207","0.3333333333333333","12","8","4","false","5848","13.0","4","4","false","0","5848","281080403"
"6.739956699542939","1.330123451421047","0.14836890570347633","0.3333333333333333","13","6","3","false","7098","5.0","3","3","false","0","7098","80314765"
"7.032234784700505","0.0","0.14220230561351896","0.0","14","2","1","false","12642","8.0","1","1","false","0","12642","0"
"6.975222516237672","7.484111184145485","0.1433646020140709","0.3333333333333333","14","6","3","false","21184","5.333333333333333","3","3","false","0","21184","626096001"
"4.933124849651191","0.2405684147428853","0.2027112693226703","0.6666666666666666","11","8","4","false","23149","21.25","4","4","false","0","23149","53211022"
"5.227808515756555","6.343913268145783","0.19128474139517762","0.2222222222222222","11","22","11","false","4442","8.5","11","10","false","1","4442","665679123"
"5.476786143853741","0.12048943979528993","0.1825888347169148","0.8333333333333334","11","8","4","false","7935","11.75","4","4","false","0","7935","26645461"
"5.24031753668511","5.090454942459622","0.19082813073815644","0.3333333333333333","11","14","7","false","25896","11.0","7","7","false","0","25896","539473307"
"5.873225884050998","1.7153233173491305","0.17026418185541675","0.35555555555555557","12","20","10","false","12406","4.8","10","10","false","0","12406","202779072"
"5.965600192446476","0.0","0.16762772692447275","1.0","11","4","2","false","16485","9.0","2","2","false","0","16485","0"
"5.992302140967044","0.0","0.16688077077478924","1.0","11","4","2","false","3034","14.5","2","2","false","0","3034","0"
"5.670194852056771","0.0","0.17636078231725427","1.0","11","8","4","false","6156","21.25","4","4","false","0","6156","0"
"5.670194852056771","0.0","0.17636078231725427","1.0","11","8","4","false","18381","21.25","4","4","false","0","18381","0"
"5.992061582872264","0.0","0.1668874703922277","1.0","11","6","3","false","19686","10.666666666666666","3","3","false","0","19686","0"
"5.992061582872264","0.0","0.1668874703922277","1.0","11","6","3","false","20335","10.666666666666666","3","3","false","0","20335","0"
"5.711570844358913","2.7788941212779728","0.17508318241165818","0.3111111111111111","11","20","10","false","22523","10.9","10","10","false","0","22523","459970007"
"8.678133269184508","0.0","0.11523215523215523","0.0","14","2","1","false","2451","2.0","1","1","false","0","2451","0"
"5.766177531873947","0.0","0.17342511472674177","1.0","12","4","2","false","2341","12.0","2","2","false","0","2341","0"
"5.976906422901131","0.0","0.16731063350237463","0.0","12","2","1","false","3508","14.0","1","1","false","0","3508","0"
"5.976906422901131","0.0","0.16731063350237463","0.0","12","2","1","false","12641","14.0","1","1","false","0","12641","0"
"5.976906422901131","0.0","0.16731063350237463","0.0","12","2","1","false","13068","14.0","1","1","false","0","13068","0"
"5.229492422420014","0.8261140402430266","0.19122314733888404","0.6071428571428571","11","16","8","false","23723","15.75","8","8","false","0","23723","160395743"
"5.423382246812605","0.0","0.1843867819915724","1.0","11","4","2","false","9713","19.5","2","2","false","0","9713","0"
"5.730334375751744","0.0","0.1745098862348348","1.0","12","4","2","false","1963","16.0","2","2","false","0","1963","0"
"5.729131585277845","0.0","0.17454652334565","1.0","12","8","4","false","4302","9.25","4","4","false","0","4302","0"
"5.729131585277845","0.0","0.17454652334565","1.0","12","8","4","false","8475","9.25","4","4","false","0","8475","0"
"5.7033918691363965","2.220568849590775","0.17533426125100174","0.4666666666666667","12","12","6","false","19022","8.5","6","6","false","0","19022","217087115"
"5.729131585277845","0.0","0.17454652334565","1.0","12","8","4","false","26181","9.25","4","4","false","0","26181","0"
"5.911955737310561","0.5336186317744048","0.16914876302083331","0.3333333333333333","11","8","4","false","364","5.25","4","4","false","0","364","37754685"
"6.270868414722155","2.7415599084209497","0.15946754641706307","0.16666666666666666","12","8","4","false","396","4.0","4","4","false","0","396","178294140"
"6.337984123165745","0.0","0.1577788742551334","0.0","12","2","1","false","13616","9.0","1","1","false","0","13616","0"
"6.250420976665865","0.07542491476219208","0.15998922372320362","0.6666666666666666","12","6","3","false","15214","5.666666666666667","3","3","false","0","15214","6214615"
"7.156122203512148","0.0","0.13974048675541212","1.0","14","4","2","false","23266","5.5","2","2","false","0","23266","0"
"1.0","2.15","1.0","0.4","1","10","5","false","5425","2.6","5","5","false","0","5425","43"
"1.4","0.0","0.7142857142857143","1.0","2","6","3","false","2784","3.6666666666666665","3","3","false","0","2784","0"
"1.4","0.0","0.7142857142857143","1.0","2","6","3","false","16109","3.6666666666666665","3","3","false","0","16109","0"
"1.6","0.0","0.625","1.0","2","4","2","false","16224","3.5","2","2","false","0","16224","0"
"1.4","0.0","0.7142857142857143","1.0","2","6","3","false","21808","3.6666666666666665","3","3","false","0","21808","0"
"1.6","0.0","0.625","1.0","2","4","2","false","24161","3.5","2","2","false","0","24161","0"
"7.5095020447438054","4.078664928042104","0.13316462184066374","0.5","13","8","4","false","21927","2.75","4","4","false","0","21927","479146090"
"8.508780370459466","0.0","0.11752565661134828","1.0","14","6","3","false","6626","3.3333333333333335","3","3","false","0","6626","0"
"8.508780370459466","0.0","0.11752565661134828","1.0","14","6","3","false","10805","3.3333333333333335","3","3","false","0","10805","0"
"6.511185951407265","5.437445576335751","0.15358185244024086","0.0","12","4","2","false","25069","4.0","2","2","false","0","25069","638937865"
"8.508780370459466","0.0","0.11752565661134828","1.0","14","6","3","false","25628","3.3333333333333335","3","3","false","0","25628","0"
"5.513350974260284","7.015009920891745","0.1813778960687639","0.3333333333333333","11","8","4","false","2239","15.75","4","4","false","0","2239","842378677"
"4.962472937214337","0.8015754016276122","0.20151243395220322","0.5","11","10","5","false","10652","15.4","5","5","false","0","10652","61184409"
"5.15227327399567","0.8189352004702556","0.19408908394808105","0.4","10","12","6","false","17984","8.666666666666666","6","6","false","0","17984","88401901"
"4.95669954293962","1.6092639422920108","0.20174714875030333","0.4","10","12","6","false","22147","11.833333333333334","6","6","false","0","22147","213259770"
"4.876593697377917","0.043995994968981336","0.2050611681136543","0.8333333333333334","11","8","4","false","22979","21.0","4","4","false","0","22979","5320261"
"5.156122203512148","0.0","0.19394420080246336","1.0","11","6","3","false","24592","15.0","3","3","false","0","24592","0"
"5.880442626894395","0.06772843865883785","0.17005522601759052","0.6666666666666666","12","6","3","false","2877","10.0","3","3","false","0","2877","10400994"
"5.911715179215781","0.0","0.1691556459816887","1.0","12","6","3","false","3876","8.333333333333334","3","3","false","0","3876","0"
"4.962472937214337","0.15937129953482773","0.20151243395220322","0.6666666666666666","11","6","3","false","7481","29.666666666666668","3","3","false","0","7481","43704415"
"5.942025499158047","0.0","0.16829278166875836","0.0","12","2","1","false","9338","17.0","1","1","false","0","9338","0"
"5.815251383209045","1.046570209089844","0.17196161164887896","0.4","11","10","5","false","12611","5.8","5","5","false","0","12611","99138199"
"5.911715179215781","0.0","0.1691556459816887","1.0","12","6","3","false","12861","8.333333333333334","3","3","false","0","12861","0"
"5.4204955496752465","0.0","0.18448497758842586","1.0","12","6","3","false","15175","17.0","3","3","false","0","15175","0"
"5.159730574933847","5.824121877806004","0.19380856916406358","0.23809523809523808","11","14","7","false","22493","11.714285714285714","7","7","false","0","22493","484338497"
"5.465239355304306","0.0","0.18297460275540295","1.0","12","4","2","false","4301","17.0","2","2","false","0","4301","0"
"5.361077700264614","0.0","0.1865296598761554","1.0","11","4","2","false","16265","16.0","2","2","false","0","16265","0"
"4.964878518162136","0.0","0.2014147972285479","1.0","11","4","2","false","21614","36.0","2","2","false","0","21614","0"
"5.004330045706038","0.6949670937013813","0.19982694803634093","0.3","11","10","5","false","7578","15.6","5","5","false","0","7578","106999323"
"5.117392350252586","10.728398513630717","0.19541202463216284","0.14285714285714285","11","28","14","false","14834","8.857142857142858","14","14","false","0","14834","991092129"
"5.431801780129901","1.2857514708425761","0.18410097431355182","0.5","11","8","4","false","15821","8.5","4","4","false","0","15821","80462496"
"5.0040894876112585","8.872709055386395","0.19983655417748292","0.16666666666666666","11","18","9","false","22100","8.555555555555555","9","9","false","0","22100","694967639"
"6.320663940341593","0.0","0.15821122740247384","1.0","12","8","4","false","11607","11.0","4","4","false","0","11607","0"
"6.320663940341593","0.0","0.15821122740247384","1.0","12","8","4","false","19351","11.0","4","4","false","0","19351","0"
"7.357228770748136","0.0","0.13592074287209","0.0","13","2","1","false","2563","8.0","1","1","false","0","2563","0"
"7.356988212653356","0.0","0.13592518719550076","1.0","13","4","2","false","8437","5.0","2","2","false","0","8437","0"
"7.356988212653356","0.0","0.13592518719550076","1.0","13","4","2","false","12071","5.0","2","2","false","0","12071","0"
"5.932403175366851","0.3071730214213321","0.16856575159158185","0.5","11","8","4","false","2770","5.25","4","4","false","0","2770","39639978"
"6.400529227808516","0.0","0.15623708046754614","1.0","12","4","2","false","6806","5.0","2","2","false","0","6806","0"
"5.690642290113062","2.420510888437305","0.17572708826513359","0.0","11","4","2","false","11806","5.0","2","2","false","0","11806","198473851"
"6.689920615828723","1.085176666652003","0.14947860481841063","0.0","12","4","2","false","8678","1.5","2","2","false","0","8678","89015699"
"7.7830165985085396","0.0","0.1284848859491871","1.0","13","4","2","false","8301","5.5","2","2","false","0","8301","0"
"7.78277604041376","1.9995378691461206E-4","0.12848885729298676","0.6666666666666666","13","6","3","false","267","4.666666666666667","3","3","false","0","267","6909"
"6.7834977146980995","3.3480573413918906","0.14741657505585304","0.2857142857142857","12","16","8","false","24240","4.125","8","8","false","0","24240","301373594"
"6.811883569882126","0.0","0.14680227425221598","1.0","12","6","3","false","6632","7.333333333333333","3","3","false","0","6632","0"
"6.811643011787346","6.987915525134693E-4","0.1468074586806046","0.6666666666666666","12","8","4","false","8386","5.75","4","4","false","0","8386","25871"
"5.813326918450806","13.394992415633038","0.17201853844243978","0.2","11","20","10","false","12187","3.9","10","10","false","0","12187","1124179305"
"6.784459947077219","0.6650355099094462","0.14739566712761054","0.6666666666666666","12","8","4","false","13153","6.75","4","4","false","0","13153","99903952"
"7.7832571566033195","0.0","0.12848091485087312","0.0","13","2","1","false","14345","8.0","1","1","false","0","14345","0"
"6.116911234063026","5.307787483709077","0.16348120182476011","0.3","11","10","5","false","10081","3.8","5","5","false","0","10081","376704056"
"7.116670675968247","0.0","0.14051514332071388","0.0","12","2","1","false","3185","5.0","1","1","false","0","3185","0"
"7.116189559778687","0.0","0.14052464336420795","1.0","12","6","3","false","13291","3.6666666666666665","3","3","false","0","13291","0"
"7.116189559778687","0.0","0.14052464336420795","1.0","12","6","3","false","20547","3.6666666666666665","3","3","false","0","20547","0"
"7.116189559778687","0.0","0.14052464336420795","1.0","12","6","3","false","20792","3.6666666666666665","3","3","false","0","20792","0"
"10.39090690401732","1.3254387522652167","0.09623799050816066","0.0","16","4","2","false","7885","2.0","2","2","false","0","7885","96384099"
"9.39162857830166","2.6508043994116397","0.1064778053840834","0.3333333333333333","15","6","3","false","19551","3.0","3","3","false","0","19551","192807381"
"11.39066634592254","0.0","0.08779117653270259","0.0","17","2","1","false","22190","2.0","1","1","false","0","22190","0"
"9.39186913639644","1.1712784632435798","0.10647507812099789","0.3333333333333333","15","6","3","false","9758","2.6666666666666665","3","3","false","0","9758","85078788"
"8.393312484965119","6.465868591841446","0.11914247227078617","0.3333333333333333","14","8","4","false","17006","2.75","4","4","false","0","17006","470518364"
"5.5169593456819825","0.0","0.1812592657190198","1.0","11","4","2","false","1859","13.5","2","2","false","0","1859","0"
"5.624969930238152","2.6312919312554883","0.17777872813582518","0.3333333333333333","11","8","4","false","4298","6.25","4","4","false","0","4298","216138161"
"5.5169593456819825","0.0","0.1812592657190198","1.0","11","4","2","false","15192","13.5","2","2","false","0","15192","0"
"5.625691604522492","0.0","0.17775592234670315","1.0","11","4","2","false","17274","11.5","2","2","false","0","17274","0"
"5.625691604522492","0.0","0.17775592234670315","1.0","11","4","2","false","18941","11.5","2","2","false","0","18941","0"
"5.550396920856387","1.2705365150845829","0.18016729510683482","0.3333333333333333","11","8","4","false","20902","9.0","4","4","false","0","20902","138475357"
"5.08563868174164","1.917188767081878","0.19663213660659384","0.21428571428571427","11","16","8","false","21798","10.125","8","8","false","0","21798","203667378"
"5.824873707000241","0.0","0.17167754191789872","0.0","10","2","1","false","3631","6.0","1","1","false","0","3631","0"
"5.883810440221313","0.0","0.16995788871172166","1.0","11","4","2","false","23901","4.5","2","2","false","0","23901","0"
"5.909309598267981","1.3243635113432357","0.16922450641156117","0.3333333333333333","12","12","6","false","13702","5.166666666666667","6","6","false","0","13702","91224575"
"5.531873947558335","2.8248870675265314","0.18077056879457298","0.4642857142857143","12","16","8","false","14667","7.875","8","8","false","0","14667","199811707"
"5.593697377916767","2.343740298996985","0.1787726314884101","0.2","12","12","6","false","17874","6.166666666666667","6","6","false","0","17874","196858735"
"6.315612220351214","0.0","0.1583377771006323","0.0","12","2","1","false","18152","9.0","1","1","false","0","18152","0"
"6.0430598989656","0.0","0.16547908124676566","1.0","12","6","3","false","19978","7.666666666666667","3","3","false","0","19978","0"
"6.493625210488333","0.0","0.15399718455953174","1.0","13","4","2","false","199","6.0","2","2","false","0","199","0"
"6.445754149627135","0.27891484330365707","0.15514088449337562","0.3333333333333333","13","6","3","false","16935","4.0","3","3","false","0","16935","17773404"
"5.1289391388020205","7.442657243184568","0.1949720932414052","0.16666666666666666","11","26","13","false","6482","6.846153846153846","13","13","false","0","6482","776230649"
"5.7654558575896075","0.46641600381468296","0.17344682271456588","0.3333333333333333","12","6","3","false","24148","7.666666666666667","3","3","false","0","24148","42416092"
"6.1017560740918935","0.030843653723890162","0.16388724620540113","0.3333333333333333","13","6","3","false","11629","9.333333333333334","3","3","false","0","11629","3011695"
"6.471734423863363","0.0","0.1545180834851132","0.0","13","2","1","false","17099","8.0","1","1","false","0","17099","0"
"5.961270146740437","1.458312380953673","0.16774948549291796","0.4","11","12","6","false","11325","8.5","6","6","false","0","11325","118147156"
"5.768342554726966","4.171701717430705","0.17336002335376788","0.14545454545454545","11","24","12","false","11318","6.545454545454546","12","11","false","1","11318","370006668"
"5.850613423141689","5.399953585615198","0.17092224826281813","0.1794871794871795","12","26","13","false","12720","6.076923076923077","13","13","false","0","12720","498969918"
"6.0938176569641564","2.3282671601047245","0.1641007421443234","0.3333333333333333","11","8","4","false","25729","8.75","4","4","false","0","25729","139217988"
"7.0300697618474866","0.0","0.14224609909663288","1.0","12","4","2","false","12743","4.0","2","2","false","0","12743","0"
"7.0300697618474866","0.0","0.14224609909663288","1.0","12","4","2","false","21712","4.0","2","2","false","0","21712","0"
"5.182583593937936","1.6997748651261535","0.1929539546973635","0.42857142857142855","11","14","7","false","950","34.714285714285715","7","7","false","0","950","692672385"
"5.17392350252586","0.06394974159318888","0.19327692021573367","0.8222222222222222","11","20","10","false","1265","17.3","10","10","false","0","1265","12204857"
"5.17416406062064","0.0","0.1932679343530615","1.0","11","18","9","false","1839","19.11111111111111","9","9","false","0","1839","0"
"5.43589126774116","0.0","0.18396247289463202","1.0","11","6","3","false","3063","28.333333333333332","3","3","false","0","3063","0"
"5.17416406062064","0.0","0.1932679343530615","1.0","11","18","9","false","3502","19.11111111111111","9","9","false","0","3502","0"
"5.3668510945393315","0.0","0.18632900044822948","1.0","11","8","4","false","4446","27.25","4","4","false","0","4446","0"
"5.231898003367814","0.16432906529847485","0.19113522460802795","0.5714285714285714","11","14","7","false","5639","25.428571428571427","7","7","false","0","5639","29355423"
"5.43565070964638","0.0","0.18397061426801203","1.0","11","8","4","false","6009","23.5","4","4","false","0","6009","0"
"5.43565070964638","0.0","0.18397061426801203","1.0","11","8","4","false","6896","23.5","4","4","false","0","6896","0"
"5.43565070964638","0.0","0.18397061426801203","1.0","11","8","4","false","9736","23.5","4","4","false","0","9736","0"
"5.43613182583594","0.0","0.1839543322417913","1.0","11","4","2","false","9980","44.5","2","2","false","0","9980","0"
"5.415924945874429","0.0","0.18464066802878207","1.0","11","4","2","false","13470","43.0","2","2","false","0","13470","0"
"5.17416406062064","0.0","0.1932679343530615","1.0","11","18","9","false","15126","19.11111111111111","9","9","false","0","15126","0"
"5.17416406062064","0.0","0.1932679343530615","1.0","11","18","9","false","16881","19.11111111111111","9","9","false","0","16881","0"
"5.17416406062064","0.0","0.1932679343530615","1.0","11","18","9","false","17828","19.11111111111111","9","9","false","0","17828","0"
"5.4354101515516","0.0","0.18397875636202699","1.0","11","6","3","false","17875","46.0","3","3","false","0","17875","0"
"5.43589126774116","0.0","0.18396247289463202","1.0","11","6","3","false","18210","28.333333333333332","3","3","false","0","18210","0"
"5.363242723117633","4.45744060763136","0.18645436196456605","0.14285714285714285","11","14","7","false","19140","13.285714285714286","7","7","false","0","19140","488860469"
"5.3668510945393315","0.0","0.18632900044822948","1.0","11","8","4","false","19316","27.25","4","4","false","0","19316","0"
"5.4354101515516","0.0","0.18397875636202699","1.0","11","6","3","false","23095","46.0","3","3","false","0","23095","0"
"5.17416406062064","0.0","0.1932679343530615","1.0","11","18","9","false","23864","19.11111111111111","9","9","false","0","23864","0"
"5.140967043541015","0.19306009777702557","0.19451593280613916","0.6363636363636364","11","24","12","false","25910","15.916666666666666","12","12","false","0","25910","33730326"
"5.43589126774116","0.0","0.18396247289463202","1.0","11","6","3","false","25917","28.333333333333332","3","3","false","0","25917","0"
"5.816213615588165","0.5094393756925223","0.17193316237902226","0.6666666666666666","12","6","3","false","14286","8.0","3","3","false","0","14286","89054817"
"5.416406062063989","0.22400244824211815","0.18462426718777755","0.3333333333333333","11","6","3","false","17131","15.333333333333334","3","3","false","0","17131","22577344"
"6.5886456579263895","5.6666622072751895","0.15177626054255358","0.13333333333333333","12","12","6","false","20940","2.5","6","6","false","0","20940","428258441"
"7.5884050998316095","0.0","0.1317799968299255","0.0","13","2","1","false","6039","6.0","1","1","false","0","6039","0"
"7.5881645417368295","0.0","0.13178417448643165","1.0","13","4","2","false","6176","4.5","2","2","false","0","6176","0"
"7.277122925186433","0.08133381095885711","0.13741694489438366","0.0","13","4","2","false","6303","4.5","2","2","false","0","6303","7209202"
"7.5881645417368295","0.0","0.13178417448643165","1.0","13","4","2","false","15161","4.5","2","2","false","0","15161","0"
"7.58792398364205","1.8565690303332412E-4","0.13178835240782424","0.6666666666666666","13","6","3","false","20949","3.3333333333333335","3","3","false","0","20949","6415"
"5.600914120760163","8.13613974444677","0.17854228406992229","0.3","11","10","5","false","22879","8.2","5","5","false","0","22879","612666232"
"5.578782776040414","7.916244418620936","0.17925057134233108","0.14545454545454545","11","22","11","false","18215","4.636363636363637","11","11","false","0","18215","600073082"
"6.600673562665384","0.0","0.15149969022194684","0.0","12","2","1","false","19051","5.0","1","1","false","0","19051","0"
"5.399085879239837","9.974103458690564","0.18521653894136517","0.12121212121212122","11","24","12","false","21125","6.75","12","12","false","0","21125","854389886"
"1.0","0.0","1.0","1.0","1","4","2","false","2656","2.0","2","2","false","0","2656","0"
"1.0","0.0","1.0","1.0","1","4","2","false","14560","2.0","2","2","false","0","14560","0"
"1.0","0.0","1.0","1.0","1","4","2","false","24251","2.0","2","2","false","0","24251","0"
"5.656964156843878","0.0","0.17677326075863242","1.0","11","6","3","false","1098","16.0","3","3","false","0","1098","0"
"6.135674765455858","0.0","0.16298125931153454","0.0","11","2","1","false","16107","9.0","1","1","false","0","16107","0"
"6.135674765455858","0.0","0.16298125931153454","0.0","11","2","1","false","26171","9.0","1","1","false","0","26171","0"
"5.460668751503488","0.0","0.18312775330396477","1.0","11","4","2","false","8150","13.0","2","2","false","0","8150","0"
"1.3333333333333333","1.5","0.75","0.0","2","6","3","false","16703","1.5","3","2","false","1","16703","9"
"2.0","0.0","0.5","0.0","3","2","1","false","13202","2.0","1","1","false","0","13202","0"
"1.3333333333333333","1.5","0.75","0.0","2","4","2","false","22253","1.5","2","2","false","0","22253","9"
"2.0","0.0","0.5","0.0","3","2","1","false","4128","2.0","1","1","false","0","4128","0"
"1.5454545454545454","1.4363636363636363","0.6470588235294118","0.4","3","12","6","false","5738","3.6666666666666665","6","6","false","0","5738","213"
"1.8181818181818181","0.0","0.55","1.0","3","6","3","false","5478","6.0","3","3","false","0","5478","0"
"1.5454545454545454","1.9545454545454544","0.6470588235294118","0.4","3","12","6","false","6538","3.6666666666666665","6","6","false","0","6538","270"
"1.4545454545454546","3.3","0.6875","0.4","2","12","6","false","8349","4.166666666666667","6","6","false","0","8349","433"
"2.4545454545454546","0.0","0.4074074074074074","0.0","4","2","1","false","12042","6.0","1","1","false","0","12042","0"
"2.1818181818181817","0.0","0.45833333333333337","1.0","4","6","3","false","17252","5.0","3","3","false","0","17252","0"
"2.1818181818181817","0.0","0.45833333333333337","1.0","4","6","3","false","18142","5.0","3","3","false","0","18142","0"
"5.75968246331489","0.0","0.17362068245416198","1.0","11","4","2","false","13501","14.5","2","2","false","0","13501","0"
"5.992542699061824","0.0","0.16687407169523502","0.0","12","2","1","false","16216","18.0","1","1","false","0","16216","0"
"1.0","0.0","1.0","0.0","1","2","1","false","1490","1.0","1","1","false","0","1490","0"
"1.0","0.0","1.0","0.0","1","2","1","false","20813","1.0","1","1","false","0","20813","0"
"6.5001202790473895","0.24393473944162386","0.15384330705747382","0.3333333333333333","12","6","3","false","4781","6.0","3","3","false","0","4781","14142654"
"6.898965600192446","0.0","0.14494926601345934","1.0","13","4","2","false","6081","5.0","2","2","false","0","6081","0"
"6.899206158287226","0.0","0.1449442119944212","0.0","13","2","1","false","6919","8.0","1","1","false","0","6919","0"
"6.898965600192446","0.0","0.14494926601345934","1.0","13","4","2","false","19358","5.0","2","2","false","0","19358","0"
"6.899206158287226","0.0","0.1449442119944212","0.0","13","2","1","false","23616","8.0","1","1","false","0","23616","0"
"5.401732018282416","0.0","0.18512580716989532","1.0","10","6","3","false","4756","13.0","3","3","false","0","4756","0"
"5.286985807072408","0.0","0.18914368914368915","1.0","11","6","3","false","5497","13.333333333333334","3","3","false","0","5497","0"
"5.523454414241039","6.012342877102251","0.18104612168459563","0.1","11","10","5","false","8298","6.4","5","5","false","0","8298","364411437"
"5.736107770026462","0.0","0.1743342419794506","1.0","11","4","2","false","12709","9.5","2","2","false","0","12709","0"
"5.667067596824634","1.7358730001437792","0.1764581034043637","0.16666666666666666","11","8","4","false","18443","6.0","4","4","false","0","18443","122447834"
"5.735626653836902","0.0","0.17434886549511386","1.0","11","4","2","false","18658","10.0","2","2","false","0","18658","0"
"5.735145537647342","1.6893022611303266","0.1743634914642842","0.3333333333333333","11","6","3","false","18667","7.0","3","3","false","0","18667","124808430"
"5.736107770026462","0.0","0.1743342419794506","1.0","11","4","2","false","26157","9.5","2","2","false","0","26157","0"
"6.1188356988212655","0.0","0.16342978455732032","0.0","11","2","1","false","450","9.0","1","1","false","0","450","0"
"5.743083954775078","5.883789534671628","0.17412247633408728","0.16666666666666666","11","8","4","false","11284","6.0","4","4","false","0","11284","420022622"
"5.7830165985085396","0.21056863778200197","0.17292013311148088","0.0","11","4","2","false","11910","7.0","2","2","false","0","11910","23686629"
"5.726485446235266","0.0","0.17462717916404116","1.0","11","4","2","false","23477","11.0","2","2","false","0","23477","0"
"5.832331007938417","0.0","0.17145803258403794","0.0","11","2","1","false","11923","13.0","1","1","false","0","11923","0"
"6.601395236949723","0.7682019095618874","0.15148312805189126","0.3333333333333333","13","6","3","false","4293","4.333333333333333","3","3","false","0","4293","105228943"
"6.80370459465961","0.0","0.14697875048615777","1.0","12","4","2","false","20616","6.5","2","2","false","0","20616","0"
"6.4354101515516","0.932492394121471","0.15539025119617225","0.3333333333333333","12","8","4","false","11602","6.75","4","4","false","0","11602","78720681"
"6.929035362039933","0.0","0.1443202333009304","0.0","12","2","1","false","5636","9.0","1","1","false","0","5636","0"
"6.929035362039933","0.0","0.1443202333009304","0.0","12","2","1","false","17988","9.0","1","1","false","0","17988","0"
"5.8628818859754634","0.0","0.17056458230756605","1.0","11","4","2","false","2883","10.0","2","2","false","0","2883","0"
"5.8628818859754634","0.0","0.17056458230756605","1.0","11","4","2","false","4015","10.0","2","2","false","0","4015","0"
"5.56386817416406","0.502708072912024","0.17973107354403564","0.5","11","8","4","false","25189","12.0","4","4","false","0","25189","96705668"
"5.263170555689199","0.0","0.1899995429407194","1.0","11","4","2","false","2055","69.5","2","2","false","0","2055","0"
"5.312484965119077","0.0","0.18823582684296322","1.0","11","18","9","false","2560","29.88888888888889","9","9","false","0","2560","0"
"5.270868414722155","0.34859596733525977","0.18972205741408424","0.5897435897435898","11","26","13","false","4146","23.307692307692307","13","13","false","0","4146","57473533"
"5.312484965119077","0.0","0.18823582684296322","1.0","11","18","9","false","10926","29.88888888888889","9","9","false","0","10926","0"
"5.312484965119077","0.0","0.18823582684296322","1.0","11","18","9","false","12553","29.88888888888889","9","9","false","0","12553","0"
"5.312484965119077","0.0","0.18823582684296322","1.0","11","18","9","false","18668","29.88888888888889","9","9","false","0","18668","0"
"7.656001924464758","4.191695744714841","0.1306164770941997","0.6666666666666666","14","8","4","false","15495","4.75","4","4","false","0","15495","612149135"
"6.660572528265576","14.479011364112575","0.15013724357122218","0.4","13","10","5","false","9264","4.0","5","5","false","0","9264","1669887986"
"7.657685831128218","0.0","0.13058775484560048","1.0","14","6","3","false","12614","5.0","3","3","false","0","12614","0"
"7.655520808275199","6.637501293665403","0.13062468577174458","0.3333333333333333","14","12","6","false","24970","3.5","6","6","false","0","24970","790477959"
"8.655039692085639","0.0","0.11553962033408377","1.0","15","4","2","false","10640","4.0","2","2","false","0","10640","0"
"8.655039692085639","0.0","0.11553962033408377","1.0","15","4","2","false","15247","4.0","2","2","false","0","15247","0"
"6.663459225402935","0.0","0.15007220216606498","1.0","13","4","2","false","17426","5.0","2","2","false","0","17426","0"
"6.00048111618956","0.1377202008989091","0.16665330339961512","0.0","12","4","2","false","3037","7.0","2","2","false","0","3037","8512407"
"6.122684628337743","0.09763162561955444","0.16332704699041334","0.0","13","4","2","false","9712","8.5","2","2","false","0","9712","6447277"
"5.732739956699543","4.284362669147203","0.1744366581343628","0.19047619047619047","12","14","7","false","10726","6.0","7","7","false","0","10726","270789090"
"5.842915564108733","4.680195967402845","0.17114743299435958","0.36363636363636365","12","22","11","false","16482","6.636363636363637","11","11","false","0","16482","268243742"
"6.142650950204475","0.9631266241255763","0.16279616213040923","0.3333333333333333","13","6","3","false","17990","6.0","3","3","false","0","17990","52667135"
"5.381044022131345","4.201946229092887","0.18583754302829808","0.5333333333333333","11","20","10","false","23151","8.5","10","10","false","0","23151","262252600"
"1.0","0.0","1.0","0.0","1","2","1","false","2339","1.0","1","1","false","0","2339","0"
"1.0","0.0","1.0","0.0","1","2","1","false","24594","1.0","1","1","false","0","24594","0"
"6.753668510945393","1.2169993190747288","0.14806767586821015","0.0","13","4","2","false","5477","1.5","2","2","false","0","5477","89229773"
"7.753427952850614","0.0","0.12897521020135894","0.0","14","2","1","false","13497","2.0","1","1","false","0","13497","0"
"5.754390185229733","2.433789915221215","0.17378036035282807","0.0","12","4","2","false","14496","12.0","2","2","false","0","14496","178482990"
"7.187635313928314","0.0","0.13912781552260786","0.0","14","2","1","false","19457","4.0","1","1","false","0","19457","0"
"6.359634351695934","1.6237052637769287","0.15724174452471915","0.5","12","8","4","false","5529","3.25","4","4","false","0","5529","107167154"
"6.024777483762328","2.138460724406158","0.16598123377919746","0.35714285714285715","12","16","8","false","5655","5.25","8","8","false","0","5655","207622636"
"6.081549194130383","0.0","0.16443178671729758","1.0","12","8","4","false","2771","6.5","4","4","false","0","2771","0"
"6.8275198460428195","0.0","0.14646607004439433","1.0","13","6","3","false","5417","6.333333333333333","3","3","false","0","5417","0"
"6.145537647341833","4.152985097832001","0.16271969311465143","0.21428571428571427","12","16","8","false","13352","5.0","8","8","false","0","13352","357658933"
"5.714698099591051","1.5959756429286982","0.1749873716113824","0.6","11","12","6","false","13619","6.333333333333333","6","6","false","0","13619","174322787"
"5.714698099591051","1.5959756429286982","0.1749873716113824","0.6","11","12","6","false","18585","6.333333333333333","6","6","false","0","18585","174322787"
"6.8275198460428195","0.0","0.14646607004439433","1.0","13","6","3","false","20513","6.333333333333333","3","3","false","0","20513","0"
"6.271830647101275","0.0","0.1594430806996011","1.0","12","4","2","false","4117","4.5","2","2","false","0","4117","0"
"6.271830647101275","0.0","0.1594430806996011","1.0","12","4","2","false","16471","4.5","2","2","false","0","16471","0"
"1.3333333333333333","0.0","0.75","1.0","2","8","4","false","4199","4.5","4","4","false","0","4199","0"
"1.3333333333333333","0.0","0.75","1.0","2","8","4","false","6443","4.5","4","4","false","0","6443","0"
"1.3333333333333333","0.0","0.75","1.0","2","8","4","false","19932","4.5","4","4","false","0","19932","0"
"1.0","2.2666666666666666","1.0","0.4","1","12","6","false","19936","3.0","6","6","false","0","19936","68"
"1.3333333333333333","0.0","0.75","1.0","2","8","4","false","25864","4.5","4","4","false","0","25864","0"
"1.8333333333333333","0.0","0.5454545454545455","0.0","2","2","1","false","2118","6.0","1","1","false","0","2118","0"
"1.8333333333333333","0.0","0.5454545454545455","0.0","2","2","1","false","26132","6.0","1","1","false","0","26132","0"
"5.928794803945153","0.08679444365456836","0.1686683437474641","0.6666666666666666","11","6","3","false","17944","9.666666666666666","3","3","false","0","17944","8354348"
"6.162376713976426","0.0","0.16227505172346487","1.0","11","4","2","false","20884","13.5","2","2","false","0","20884","0"
"6.093577098869377","0.0","0.1641072204018791","1.0","11","28","14","false","200","15.0","14","14","false","0","200","0"
"6.093577098869377","0.0","0.1641072204018791","1.0","11","28","14","false","492","15.0","14","14","false","0","492","0"
"5.319942266057253","2.1210182394415926","0.1879719647298214","0.35714285714285715","11","16","8","false","4422","14.5","8","8","false","0","4422","210659378"
"6.093577098869377","0.0","0.1641072204018791","1.0","11","28","14","false","6708","15.0","14","14","false","0","6708","0"
"5.789752225162377","4.3028545899045065","0.17271896293834135","0.6339869281045751","11","36","18","false","7013","16.055555555555557","18","18","false","0","7013","406749236"
"6.093577098869377","0.0","0.1641072204018791","1.0","11","28","14","false","8151","15.0","14","14","false","0","8151","0"
"6.093577098869377","0.0","0.1641072204018791","1.0","11","28","14","false","9020","15.0","14","14","false","0","9020","0"
"6.093577098869377","0.0","0.1641072204018791","1.0","11","28","14","false","9021","15.0","14","14","false","0","9021","0"
"6.093577098869377","0.0","0.1641072204018791","1.0","11","28","14","false","9208","15.0","14","14","false","0","9208","0"
"6.093577098869377","0.0","0.1641072204018791","1.0","11","28","14","false","9722","15.0","14","14","false","0","9722","0"
"6.162376713976426","0.0","0.16227505172346487","1.0","11","4","2","false","16719","13.0","2","2","false","0","16719","0"
"6.093577098869377","0.0","0.1641072204018791","1.0","11","28","14","false","16882","15.0","14","14","false","0","16882","0"
"6.162376713976426","0.0","0.16227505172346487","1.0","11","4","2","false","17016","13.0","2","2","false","0","17016","0"
"6.093577098869377","0.0","0.1641072204018791","1.0","11","28","14","false","17022","15.0","14","14","false","0","17022","0"
"6.093577098869377","0.0","0.1641072204018791","1.0","11","28","14","false","19586","15.0","14","14","false","0","19586","0"
"6.093577098869377","0.0","0.1641072204018791","1.0","11","28","14","false","19678","15.0","14","14","false","0","19678","0"
"6.093577098869377","0.0","0.1641072204018791","1.0","11","28","14","false","24861","15.0","14","14","false","0","24861","0"
"1.0","0.0","1.0","1.0","1","4","2","false","9994","2.0","2","2","false","0","9994","0"
"1.0","0.0","1.0","1.0","1","4","2","false","17276","2.0","2","2","false","0","17276","0"
"1.0","0.0","1.0","1.0","1","4","2","false","18383","2.0","2","2","false","0","18383","0"
"5.647582391147462","0.0","0.1770669165566299","1.0","11","8","4","false","12701","7.75","4","4","false","0","12701","0"
"5.647582391147462","0.0","0.1770669165566299","1.0","11","8","4","false","18879","7.75","4","4","false","0","18879","0"
"5.970411354342073","0.0","0.16749264676256095","0.0","11","2","1","false","11841","6.0","1","1","false","0","11841","0"
"7.235506374789511","0.0","0.138207327614868","0.0","13","2","1","false","20550","2.0","1","1","false","0","20550","0"
"5.921337503006976","1.5055566792184645","0.16888076376193378","0.3333333333333333","12","18","9","false","4211","6.222222222222222","9","9","false","0","4211","239030385"
"6.010825114265095","0.0","0.16636651058550447","1.0","12","4","2","false","7104","12.5","2","2","false","0","7104","0"
"5.921818619196536","1.139183946991636","0.16886704310029654","0.38095238095238093","12","14","7","false","11670","6.857142857142857","7","7","false","0","11670","177954622"
"6.009622323791196","0.26976020016963365","0.1663998078616604","0.7","12","10","5","false","11876","8.0","5","5","false","0","11876","39318376"
"6.009862881885976","0.0","0.1663931473401913","1.0","12","8","4","false","17808","9.25","4","4","false","0","17808","0"
"6.573249939860476","0.0264868628984672","0.15213174748398903","0.6666666666666666","13","8","4","false","24121","7.5","4","4","false","0","24121","6507040"
"6.920375270627857","0.0","0.1445008342602892","1.0","13","4","2","false","25962","8.0","2","2","false","0","25962","0"
"1.0","0.0","1.0","0.0","1","2","1","false","22283","1.0","1","1","false","0","22283","0"
"1.0","0.0","1.0","0.0","1","2","1","false","15824","1.0","1","1","false","0","15824","0"
"6.200144334856868","0.0","0.1612865678590828","1.0","12","8","4","false","21195","4.5","4","4","false","0","21195","0"
"6.200144334856868","0.0","0.1612865678590828","1.0","12","8","4","false","15171","4.5","4","4","false","0","15171","0"
"5.201106567235987","4.712598020477768","0.192266777669858","0.4666666666666667","11","12","6","false","15305","10.0","6","6","false","0","15305","333657852"
"6.200144334856868","0.0","0.1612865678590828","1.0","12","8","4","false","17864","4.5","4","4","false","0","17864","0"
"6.200144334856868","0.0","0.1612865678590828","1.0","12","8","4","false","23417","4.5","4","4","false","0","23417","0"
"6.28145297089247","0.0","0.15919883578431374","1.0","12","8","4","false","4139","10.25","4","4","false","0","4139","0"
"6.850372865046909","0.0","0.14597745549039576","0.0","13","2","1","false","5698","13.0","1","1","false","0","5698","0"
"5.949482800096224","0.9512279403445707","0.16808183729581108","0.5","12","10","5","false","9659","6.2","5","5","false","0","9659","90943921"
"6.016598508539812","0.8540514483483288","0.16620686897764983","0.47619047619047616","11","14","7","false","10496","8.714285714285714","7","7","false","0","10496","66387649"
"6.850372865046909","0.0","0.14597745549039576","0.0","13","2","1","false","11713","13.0","1","1","false","0","11713","0"
"6.28145297089247","0.0","0.15919883578431374","1.0","12","8","4","false","20002","10.25","4","4","false","0","20002","0"
"6.687515034880923","0.0","0.14953237410071943","1.0","13","4","2","false","25598","9.0","2","2","false","0","25598","0"
"5.401732018282416","5.063538340194351","0.18512580716989532","0.35714285714285715","11","16","8","false","25607","7.75","8","8","false","0","25607","477211363"
"6.244888140485927","0.0","0.16013097072419105","1.0","12","6","3","false","25661","8.666666666666666","3","3","false","0","25661","0"
"6.103439980755352","0.09283505665456022","0.16384203058489674","0.0","11","4","2","false","4138","9.5","2","2","false","0","4138","10868011"
"5.885734904979553","0.6125733530513916","0.16990231740711978","0.3333333333333333","12","8","4","false","11328","9.25","4","4","false","0","11328","51625289"
"1.5","0.0","0.6666666666666666","1.0","2","4","2","false","2455","3.0","2","2","false","0","2455","0"
"1.5","0.0","0.6666666666666666","1.0","2","4","2","false","14353","3.0","2","2","false","0","14353","0"
"1.0","2.333333333333333","1.0","0.3333333333333333","1","8","4","false","14886","2.0","4","4","false","0","14886","28"
"1.5","0.0","0.6666666666666666","1.0","2","4","2","false","2043","3.0","2","2","false","0","2043","0"
"1.5","0.0","0.6666666666666666","1.0","2","4","2","false","6315","3.0","2","2","false","0","6315","0"
"7.591772913158528","0.0","0.13172153743781487","0.0","13","2","1","false","21131","3.0","1","1","false","0","21131","0"
"7.591772913158528","0.0","0.13172153743781487","0.0","13","2","1","false","23859","3.0","1","1","false","0","23859","0"
"1.1666666666666667","3.433333333333333","0.8571428571428571","0.1","2","10","5","false","5156","1.6","5","5","false","0","5156","103"
"2.0","0.0","0.5","0.0","3","2","1","false","7483","5.0","1","1","false","0","7483","0"
"1.8333333333333333","0.0","0.5454545454545455","1.0","3","4","2","false","10904","3.5","2","2","false","0","10904","0"
"1.8333333333333333","0.0","0.5454545454545455","1.0","3","4","2","false","12707","3.5","2","2","false","0","12707","0"
"1.6666666666666667","1.7","0.6","0.0","2","4","2","false","14282","3.0","2","2","false","0","14282","51"
"2.0","0.0","0.5","0.0","3","2","1","false","17933","5.0","1","1","false","0","17933","0"
"1.0","0.0","1.0","0.0","1","2","1","false","294","1.0","1","1","false","0","294","0"
"1.0","0.0","1.0","0.0","1","2","1","false","8626","1.0","1","1","false","0","8626","0"
"7.167428433966803","0.0","0.13952005370028528","0.0","13","2","1","false","21546","3.0","1","1","false","0","21546","0"
"1.0","0.0","1.0","0.0","1","2","1","false","11459","1.0","1","1","false","0","11459","0"
"1.0","0.0","1.0","0.0","1","2","1","false","6706","1.0","1","1","false","0","6706","0"
"1.0","1.3333333333333333","1.0","0.3333333333333333","1","6","3","false","8428","1.6666666666666667","3","3","false","0","8428","8"
"1.3333333333333333","0.0","0.75","1.0","2","4","2","false","10637","2.5","2","2","false","0","10637","0"
"1.6666666666666667","0.0","0.6","0.0","2","2","1","false","18603","3.0","1","1","false","0","18603","0"
"1.3333333333333333","0.0","0.75","1.0","2","4","2","false","21340","2.5","2","2","false","0","21340","0"
"5.9511667067596825","0.0","0.16803427786086744","0.0","11","2","1","false","12868","12.0","1","1","false","0","12868","0"
"5.9511667067596825","0.0","0.16803427786086744","0.0","11","2","1","false","17180","12.0","1","1","false","0","17180","0"
"5.191484243444792","23.689751928232756","0.19262314072563827","0.39285714285714285","10","16","8","false","17738","16.25","8","8","false","0","17738","1913844893"
"5.9511667067596825","0.0","0.16803427786086744","0.0","11","2","1","false","18154","12.0","1","1","false","0","18154","0"
"6.360837142169834","0.0","0.15721201119431208","1.0","11","6","3","false","16213","5.0","3","3","false","0","16213","0"
"6.149627134953091","0.16788887042651382","0.16261148490064153","0.4","11","10","5","false","20383","5.6","5","5","false","0","20383","10772944"
"5.9073851335097425","0.17789298744966958","0.16927963513458485","0.5","11","8","4","false","24870","4.5","4","4","false","0","24870","32015355"
"5.798412316574453","0.0","0.17246100232326583","1.0","12","6","3","false","6703","9.0","3","3","false","0","6703","0"
"5.801539571806591","0.0","0.17236803914251358","1.0","12","4","2","false","12803","10.5","2","2","false","0","12803","0"
"5.060380081789752","0.9884474065549523","0.19761361475565697","0.3333333333333333","11","8","4","false","13999","15.75","4","4","false","0","13999","93201320"
"5.798412316574453","0.0","0.17246100232326583","1.0","12","6","3","false","15596","9.0","3","3","false","0","15596","0"
"5.801539571806591","0.0","0.17236803914251358","1.0","12","4","2","false","17592","10.5","2","2","false","0","17592","0"
"5.795044503247534","5.191023608627516","0.1725612287256123","0.4","12","12","6","false","18920","5.833333333333333","6","6","false","0","18920","343486999"
"5.389944671638201","0.0","0.1855306614299741","1.0","11","4","2","false","15657","12.5","2","2","false","0","15657","0"
"6.074573009381766","1.1430587371330052","0.16462062410898146","0.4","12","10","5","false","10878","5.2","5","5","false","0","10878","69825489"
"6.754630743324513","0.0","0.1480465828555148","1.0","13","4","2","false","26020","4.0","2","2","false","0","26020","0"
"7.941544382968487","0.0","0.12592009208493624","1.0","13","6","3","false","11034","3.3333333333333335","3","3","false","0","11034","0"
"7.941544382968487","0.0","0.12592009208493624","1.0","13","6","3","false","18764","3.3333333333333335","3","3","false","0","18764","0"
"7.941544382968487","0.0","0.12592009208493624","1.0","13","6","3","false","22433","3.3333333333333335","3","3","false","0","22433","0"
"6.781573249939861","0.0","0.14745840871200028","0.0","12","2","1","false","9093","4.0","1","1","false","0","9093","0"
"6.045706038008179","0.0","0.16540665287283146","0.0","12","2","1","false","13680","10.0","1","1","false","0","13680","0"
"5.0045706038008175","17.52333983950877","0.19981734281868874","0.1282051282051282","10","26","13","false","13346","6.538461538461538","13","13","false","0","13346","1446277031"
"6.215299494828001","5.407382065757415","0.16089329256492627","0.5","12","10","5","false","6183","5.4","5","5","false","0","6183","573201117"
"7.213856146259322","0.27683039859404834","0.13862211551287182","0.7","13","10","5","false","369","4.0","5","5","false","0","369","67236320"
"7.214337262448882","0.0","0.13861287095698566","1.0","13","6","3","false","7727","5.0","3","3","false","0","7727","0"
"7.213856146259322","0.27683039859404834","0.13862211551287182","0.7","13","10","5","false","16433","4.0","5","5","false","0","16433","67236320"
"7.214096704354102","0.27660949147934005","0.1386174930807963","0.8333333333333334","13","8","4","false","16570","4.5","4","4","false","0","16570","67226899"
"6.21722395958624","0.773775081191251","0.16084349003675757","0.0","12","4","2","false","5601","5.5","2","2","false","0","5601","62620853"
"6.04450324753428","2.727241528496893","0.1654395669996418","0.26666666666666666","12","12","6","false","7645","5.333333333333333","6","6","false","0","7645","228232126"
"1.0","0.0","1.0","0.0","1","2","1","false","13675","1.0","1","1","false","0","13675","0"
"1.0","0.0","1.0","0.0","1","2","1","false","4186","1.0","1","1","false","0","4186","0"
"1.0","0.0","1.0","1.0","1","4","2","false","12616","2.0","2","2","false","0","12616","0"
"1.0","0.0","1.0","1.0","1","4","2","false","4485","2.0","2","2","false","0","4485","0"
"1.0","0.0","1.0","1.0","1","4","2","false","16266","2.0","2","2","false","0","16266","0"
"8.971373586721192","0.0","0.11146565131120288","0.0","16","2","1","false","1822","5.0","1","1","false","0","1822","0"
"7.971614144815973","6.35366855725109","0.12544510833484218","0.0","15","10","5","false","6503","2.0","5","5","false","0","6503","530721829"
"8.971373586721192","0.0","0.11146565131120288","0.0","16","2","1","false","3773","5.0","1","1","false","0","3773","0"
"8.971373586721192","0.0","0.11146565131120288","0.0","16","2","1","false","12887","5.0","1","1","false","0","12887","0"
"8.969930238152514","1.8101191491883883","0.11148358721304441","0.0","16","8","4","false","21695","2.0","4","4","false","0","21695","149079290"
"5.532114505653115","3.7836769080849","0.18076270817932774","0.3","12","10","5","false","1594","10.4","5","5","false","0","1594","355592238"
"6.821987009862882","0.0","0.14658485842237032","1.0","12","8","4","false","4774","5.5","4","4","false","0","4774","0"
"6.821987009862882","0.0","0.14658485842237032","1.0","12","8","4","false","5673","5.5","4","4","false","0","5673","0"
"5.990618234303584","0.4720827603257493","0.1669276793960567","0.6666666666666666","12","6","3","false","15382","8.666666666666666","3","3","false","0","15382","69128701"
"6.706038008178975","0.7915468108585222","0.1491193456971697","0.42857142857142855","12","14","7","false","16717","4.571428571428571","7","7","false","0","16717","69047902"
"6.821987009862882","0.0","0.14658485842237032","1.0","12","8","4","false","19603","5.5","4","4","false","0","19603","0"
"6.779648785181621","0.0","0.14750026611787248","0.0","12","2","1","false","15172","2.0","1","1","false","0","15172","0"
"2.25","0.0","0.4444444444444444","0.0","3","2","1","false","17076","2.0","1","1","false","0","17076","0"
"1.5","1.6666666666666665","0.6666666666666666","0.0","2","4","2","false","19018","2.0","2","2","false","0","19018","20"
"1.25","2.1666666666666665","0.8","0.3333333333333333","2","6","3","false","17595","2.0","3","3","false","0","17595","26"
"5.964156843877796","9.455357530582656","0.16766829346993103","0.21428571428571427","12","16","8","false","5078","4.75","8","8","false","0","5078","907751423"
"5.425066153476065","8.200178216612384","0.18432954948563318","0.2857142857142857","11","16","8","false","25172","7.5","8","8","false","0","25172","872160256"
"2.5","0.0","0.4","0.0","3","2","1","false","11035","2.0","1","1","false","0","11035","0"
"6.200625451046427","0.0028051383347961006","0.16127405338299194","0.6666666666666666","12","6","3","false","21864","7.0","3","3","false","0","21864","161351"
"6.209526100553283","0.0","0.16104288536783792","1.0","12","4","2","false","4284","9.0","2","2","false","0","4284","0"
"5.943709405821506","0.13080630245582436","0.1682451028007123","0.3333333333333333","12","8","4","false","9643","16.75","4","4","false","0","9643","14577334"
"5.406543180178013","0.0","0.18496106785317018","1.0","11","10","5","false","13837","22.8","5","5","false","0","13837","0"
"6.209526100553283","0.0","0.16104288536783792","1.0","12","4","2","false","15194","8.5","2","2","false","0","15194","0"
"6.096223237911956","0.0","0.16403598768842237","1.0","12","6","3","false","15623","10.333333333333334","3","3","false","0","15623","0"
"5.406543180178013","0.0","0.18496106785317018","1.0","11","10","5","false","17250","22.8","5","5","false","0","17250","0"
"5.691123406302622","0.5437582689903362","0.17571223264857555","0.3333333333333333","12","12","6","false","23470","9.333333333333334","6","6","false","0","23470","78122207"
"6.096223237911956","0.0","0.16403598768842237","1.0","12","6","3","false","25094","10.333333333333334","3","3","false","0","25094","0"
"6.209526100553283","0.0","0.16104288536783792","1.0","12","4","2","false","26067","8.5","2","2","false","0","26067","0"
"5.074573009381766","3.7380623171636493","0.19706091490874617","0.28888888888888886","11","20","10","false","6056","16.3","10","10","false","0","6056","745176065"
"5.45609814770267","0.0","0.18328116044266124","1.0","11","4","2","false","17289","24.0","2","2","false","0","17289","0"
"5.3319701707962475","3.9168649514193996","0.18754793593503272","0.32142857142857145","11","16","8","false","23051","13.25","8","8","false","0","23051","848191276"
"5.864565792638922","2.400552287585645","0.17051560769514745","0.41304347826086957","11","48","24","false","8823","12.5","24","24","false","0","8823","782459287"
"5.375270627856628","0.5436064211026344","0.18603714477511746","0.0","11","4","2","false","9194","16.5","2","2","false","0","9194","32125550"
"5.3846523935530435","1.2420265322745303","0.18571300929235166","0.0","11","4","2","false","6635","20.5","2","2","false","0","6635","87593846"
"5.429636757276882","0.0","0.18417438305790615","1.0","11","6","3","false","9216","14.0","3","3","false","0","9216","0"
"5.618715419773875","0.0","0.17797662371023676","0.0","11","2","1","false","19019","20.0","1","1","false","0","19019","0"
"5.429636757276882","0.0","0.18417438305790615","1.0","11","6","3","false","22507","14.0","3","3","false","0","22507","0"
"5.926148664902574","4.132568208061008","0.16874365739801095","0.3333333333333333","12","12","6","false","5519","5.0","6","6","false","0","5519","261123893"
"5.947558335337984","0.0","0.16813622391198835","0.0","12","2","1","false","5730","13.0","1","1","false","0","5730","0"
"5.559538128458023","1.6258174402534957","0.17987105707238976","0.16666666666666666","12","8","4","false","11047","10.25","4","4","false","0","11047","104610130"
"5.947558335337984","0.0","0.16813622391198835","0.0","12","2","1","false","15252","13.0","1","1","false","0","15252","0"
"5.852056771710368","0.0","0.17088009207876023","1.0","12","4","2","false","21289","11.5","2","2","false","0","21289","0"
"5.945393312484965","0.0","0.16819745094072425","1.0","12","4","2","false","26167","9.5","2","2","false","0","26167","0"
"7.071926870339187","0.0","0.1414041771549085","0.0","13","2","1","false","25112","7.0","1","1","false","0","25112","0"
"6.502044743805629","0.0","0.15379777276258833","0.0","12","2","1","false","13389","9.0","1","1","false","0","13389","0"
"6.555208082751984","0.0","0.15255045871559633","0.0","11","2","1","false","6185","6.0","1","1","false","0","6185","0"
"5.582872263651672","1.186057215062223","0.1791192692175112","0.0","10","6","3","false","23224","6.666666666666667","3","3","false","0","23224","92685009"
"6.317055568919894","8.587227150617538","0.15830159939070831","0.1388888888888889","11","18","9","false","24412","3.111111111111111","9","9","false","0","24412","711024524"
"7.636516718787587","1.1037506919807563","0.13094975586706567","0.5","13","8","4","false","5363","2.75","4","4","false","0","5363","150787918"
"7.636757276882367","0.0","0.13094563094563094","1.0","13","6","3","false","253","3.6666666666666665","3","3","false","0","253","0"
"7.636757276882367","0.0","0.13094563094563094","1.0","13","6","3","false","4634","3.6666666666666665","3","3","false","0","4634","0"
"8.636276160692807","0.0","0.11579064650009749","0.0","14","2","1","false","17122","4.0","1","1","false","0","17122","0"
"6.637719509261487","4.415361868601566","0.150654151415214","0.5","12","8","4","false","21051","7.0","4","4","false","0","21051","603608084"
"1.5","0.0","0.6666666666666666","0.0","2","2","1","false","2259","2.0","1","1","false","0","2259","0"
"1.0","2.5","1.0","0.0","1","4","2","false","10317","1.0","2","2","false","0","10317","5"
"1.5","0.0","0.6666666666666666","0.0","2","2","1","false","11816","2.0","1","1","false","0","11816","0"
"1.0","0.0","1.0","0.0","1","2","1","false","6448","1.0","1","1","false","0","6448","0"
"1.0","0.0","1.0","0.0","1","2","1","false","1346","1.0","1","1","false","0","1346","0"
"2.0","0.0","0.5","1.0","3","4","2","false","2136","9.0","2","2","false","0","2136","0"
"1.1538461538461537","4.67628205128205","0.8666666666666667","0.2727272727272727","2","22","11","false","9591","4.0","11","11","false","0","9591","995"
"1.5384615384615385","0.6057692307692306","0.6499999999999999","0.5714285714285714","3","14","7","false","17453","5.428571428571429","7","7","false","0","17453","227"
"1.6153846153846154","0.9775641025641022","0.6190476190476191","0.5","2","10","5","false","309","5.6","5","5","false","0","309","364"
"2.076923076923077","0.0","0.48148148148148145","0.0","3","2","1","false","2186","11.0","1","1","false","0","2186","0"
"1.7692307692307692","0.0","0.5652173913043479","1.0","3","10","5","false","6012","6.6","5","5","false","0","6012","0"
"1.7692307692307692","0.0","0.5652173913043479","1.0","2","6","3","false","10677","7.0","3","3","false","0","10677","0"
"1.7692307692307692","0.0","0.5652173913043479","1.0","3","10","5","false","11030","6.6","5","5","false","0","11030","0"
"2.076923076923077","0.0","0.48148148148148145","0.0","3","2","1","false","13704","11.0","1","1","false","0","13704","0"
"1.6153846153846154","1.5480769230769231","0.6190476190476191","0.4","2","10","5","false","17015","4.4","5","5","false","0","17015","368"
"1.7692307692307692","0.0","0.5652173913043479","1.0","3","10","5","false","23946","6.6","5","5","false","0","23946","0"
"1.7692307692307692","0.0","0.5652173913043479","1.0","3","10","5","false","25611","6.6","5","5","false","0","25611","0"
"1.0","0.0","1.0","0.0","1","2","1","false","1050","1.0","1","1","false","0","1050","0"
"1.0","0.0","1.0","0.0","1","2","1","false","17120","1.0","1","1","false","0","17120","0"
"1.0","0.0","1.0","0.0","1","2","1","false","9595","1.0","1","1","false","0","9595","0"
"1.0","0.0","1.0","0.0","1","2","1","false","6744","1.0","1","1","false","0","6744","0"
"6.639643974019726","0.0","0.15061048512735045","0.0","12","2","1","false","1125","18.0","1","1","false","0","1125","0"
"6.639403415924946","0.0","0.1506159420289855","1.0","12","4","2","false","8055","10.0","2","2","false","0","8055","0"
"6.638922299735386","0.49186298931519196","0.15062685701862455","0.6666666666666666","12","6","3","false","8526","7.666666666666667","3","3","false","0","8526","134697566"
"6.639643974019726","0.0","0.15061048512735045","0.0","12","2","1","false","9486","18.0","1","1","false","0","9486","0"
"6.635795044503247","11.317662405076215","0.1506978430306326","0.0","12","8","4","false","11537","6.5","4","4","false","0","11537","1542366736"
"5.363964397401973","13.768692237470702","0.1864292761682662","0.24761904761904763","11","30","15","false","12453","10.333333333333334","15","15","false","0","12453","1618991754"
"6.639403415924946","0.0","0.1506159420289855","1.0","12","4","2","false","18880","10.0","2","2","false","0","18880","0"
"6.639643974019726","0.0","0.15061048512735045","0.0","12","2","1","false","18909","18.0","1","1","false","0","18909","0"
"6.484724560981477","0.0","0.15420855436435804","1.0","12","4","2","false","19962","11.0","2","2","false","0","19962","0"
"6.638922299735386","0.49186298931519196","0.15062685701862455","0.6666666666666666","12","6","3","false","23476","7.666666666666667","3","3","false","0","23476","134697566"
"5.823670916526341","0.15041986330093152","0.17171299929778183","0.0","11","6","3","false","19078","7.0","3","3","false","0","19078","17616833"
"5.505171999037768","0.37364911419615743","0.18164736727113828","0.5","11","8","4","false","20427","8.75","4","4","false","0","20427","23762594"
"5.941784941063267","0.0","0.1682995951417004","1.0","11","4","2","false","8520","7.5","2","2","false","0","8520","0"
"6.008900649506856","0.11371694753291094","0.16641979262580567","0.6666666666666666","11","6","3","false","16177","6.333333333333333","3","3","false","0","16177","13726525"
"5.660331970170796","0.658089331766789","0.17666808329791756","0.3333333333333333","11","12","6","false","21100","6.0","6","6","false","0","21100","54113464"
"5.644214577820543","0.019250697629422504","0.1771725695776329","0.6666666666666666","11","6","3","false","21156","9.666666666666666","3","3","false","0","21156","2742822"
"6.070964637960067","0.0","0.16471846891468875","1.0","12","4","2","false","9125","3.5","2","2","false","0","9125","0"
"6.070964637960067","0.0","0.16471846891468875","1.0","12","4","2","false","15943","3.5","2","2","false","0","15943","0"
"7.689680057733943","0.0","0.130044422198586","0.0","13","2","1","false","15626","2.0","1","1","false","0","15626","0"
"1.5","0.0","0.6666666666666666","1.0","2","4","2","false","1154","3.0","2","2","false","0","1154","0"
"1.5","0.0","0.6666666666666666","1.0","2","4","2","false","12017","3.0","2","2","false","0","12017","0"
"1.0","1.8333333333333333","1.0","0.3333333333333333","1","8","4","false","12930","2.0","4","4","false","0","12930","22"
"1.5","0.0","0.6666666666666666","1.0","2","4","2","false","8704","3.0","2","2","false","0","8704","0"
"1.5","0.0","0.6666666666666666","1.0","2","4","2","false","17591","3.0","2","2","false","0","17591","0"
"1.0","0.0","1.0","0.0","1","2","1","false","12161","1.0","1","1","false","0","12161","0"
"1.0","0.0","1.0","0.0","1","2","1","false","19162","1.0","1","1","false","0","19162","0"
"5.822227567957662","0.0","0.17175556749163326","1.0","12","6","3","false","1093","6.0","3","3","false","0","1093","0"
"5.822227567957662","0.0","0.17175556749163326","1.0","12","6","3","false","3059","6.0","3","3","false","0","3059","0"
"5.734664421457782","0.053993814938803626","0.17437811988757917","0.6666666666666666","12","8","4","false","9649","8.25","4","4","false","0","9649","8007953"
"5.734423863363002","0.05788624948690743","0.17438543501971643","0.6","12","10","5","false","10251","7.2","5","5","false","0","10251","4270005"
"5.822708684147222","0.0","0.1717413757488122","0.0","12","2","1","false","25903","10.0","1","1","false","0","25903","0"
"7.093336540774597","0.09811726005625908","0.1409773798623122","0.4","14","10","5","false","4143","5.6","5","5","false","0","4143","6745344"
"7.097666586480635","0.0","0.14089137434333163","1.0","14","8","4","false","6808","6.5","4","4","false","0","6808","0"
"7.097666586480635","0.0","0.14089137434333163","1.0","14","8","4","false","7802","6.5","4","4","false","0","7802","0"
"7.096463796006736","0.0","0.14091525423728812","1.0","14","6","3","false","17127","7.0","3","3","false","0","17127","0"
"7.098388260764975","0.0","0.1408770502914464","0.0","14","2","1","false","20554","13.0","1","1","false","0","20554","0"
"7.098147702670195","0.0","0.14088182465177754","1.0","14","4","2","false","21777","9.0","2","2","false","0","21777","0"
"7.097426028385855","4.17445856485217E-4","0.14089614967462039","0.7","14","10","5","false","22108","5.4","5","5","false","0","22108","14424"
"7.097666586480635","0.0","0.14089137434333163","1.0","14","8","4","false","23555","6.5","4","4","false","0","23555","0"
"7.096463796006736","0.0","0.14091525423728812","1.0","14","6","3","false","25718","7.0","3","3","false","0","25718","0"
"6.046427712292519","0.0","0.16538691068231548","1.0","13","6","3","false","4247","12.666666666666666","3","3","false","0","4247","0"
"6.046427712292519","0.0","0.16538691068231548","1.0","13","6","3","false","4250","12.666666666666666","3","3","false","0","4250","0"
"6.174404618715419","0.0","0.16195893559823898","1.0","13","4","2","false","8726","10.0","2","2","false","0","8726","0"
"6.1729612701467405","0.09022031057339526","0.16199680448930284","0.8333333333333334","13","8","4","false","9491","9.5","4","4","false","0","9491","25814515"
"5.984604281934087","1.0126138259322144","0.16709542567730526","0.42857142857142855","13","16","8","false","11379","8.125","8","8","false","0","11379","129327328"
"6.1460187635313925","0.0","0.1627069552624369","1.0","13","4","2","false","11405","11.0","2","2","false","0","11405","0"
"6.174404618715419","0.0","0.16195893559823898","1.0","13","4","2","false","15196","10.0","2","2","false","0","15196","0"
"6.067115708443589","0.026887742331505957","0.16482296498949287","0.6666666666666666","12","6","3","false","15938","11.333333333333334","3","3","false","0","15938","4942102"
"6.10969449121963","0.0","0.1636743050633908","1.0","12","4","2","false","17126","14.5","2","2","false","0","17126","0"
"5.989415443829685","0.2577666385326848","0.166961201702948","0.5238095238095238","12","14","7","false","17764","8.0","7","7","false","0","17764","50432584"
"5.9514072648544625","0.0","0.16802748585286983","0.0","11","2","1","false","232","15.0","1","1","false","0","232","0"
"5.9514072648544625","0.0","0.16802748585286983","0.0","11","2","1","false","1075","15.0","1","1","false","0","1075","0"
"5.9511667067596825","0.0","0.16803427786086744","1.0","11","4","2","false","8737","10.0","2","2","false","0","8737","0"
"5.9514072648544625","0.0","0.16802748585286983","0.0","11","2","1","false","13481","15.0","1","1","false","0","13481","0"
"5.950445032475343","0.0","0.1680546571798189","1.0","11","6","3","false","13862","8.333333333333334","3","3","false","0","13862","0"
"5.9514072648544625","0.0","0.16802748585286983","0.0","11","2","1","false","16742","15.0","1","1","false","0","16742","0"
"5.949963916285783","2.1473233107739693","0.1680682461389181","0.4","11","10","5","false","24402","5.4","5","5","false","0","24402","195319476"
"6.1286985807072405","0.24882201064381604","0.16316677787808612","0.5","12","8","4","false","128","6.5","4","4","false","0","128","17188222"
"5.823430358431561","1.5478810879220168","0.17172009253139459","0.4666666666666667","12","12","6","false","4353","6.666666666666667","6","6","false","0","4353","99305909"
"6.160933365407746","0.0","0.1623130686033345","1.0","12","8","4","false","6558","8.0","4","4","false","0","6558","0"
"6.2343035843156125","0.0","0.16040283994443585","1.0","12","6","3","false","6920","8.0","3","3","false","0","6920","0"
"6.160933365407746","0.0","0.1623130686033345","1.0","12","8","4","false","14865","8.0","4","4","false","0","14865","0"
"6.159971133028626","2.8764987706995147","0.16233842308743704","0.6","12","10","5","false","15941","7.0","5","5","false","0","15941","178695448"
"6.2343035843156125","0.0","0.16040283994443585","1.0","12","6","3","false","16877","8.0","3","3","false","0","16877","0"
"6.309117151792158","0.0","0.15850078163724404","0.0","12","2","1","false","10000","13.0","1","1","false","0","10000","0"
"6.006013952369497","0.7701597492548969","0.16649977970921617","0.0","12","4","2","false","17337","11.0","2","2","false","0","17337","50547452"
"6.309117151792158","0.0","0.15850078163724404","0.0","12","2","1","false","21634","13.0","1","1","false","0","21634","0"
"5.834014914601877","3.4487758062914975","0.171408543625268","0.3333333333333333","11","12","6","false","851","6.833333333333333","6","6","false","0","851","276334910"
"5.639643974019726","0.0","0.17731615765227776","1.0","11","6","3","false","2713","9.333333333333334","3","3","false","0","2713","0"
"5.057012268462834","2.8187033017260945","0.19774521929407288","0.4","10","10","5","false","13199","10.8","5","5","false","0","13199","260989672"
"5.886697137358672","0.0","0.16987454538024602","0.0","11","2","1","false","16837","19.0","1","1","false","0","16837","0"
"5.886697137358672","0.0","0.16987454538024602","0.0","11","2","1","false","18032","19.0","1","1","false","0","18032","0"
"5.433245128698581","0.16648385437141563","0.1840520676525281","0.6666666666666666","11","8","4","false","19568","13.0","4","4","false","0","19568","21935983"
"5.777243204233822","0.0","0.1730929380413058","1.0","11","6","3","false","20004","11.0","3","3","false","0","20004","0"
"5.604281934087082","1.3440510403899264","0.1784349916298236","0.5","11","8","4","false","1341","12.5","4","4","false","0","1341","98556667"
"5.56362761606928","0.0","0.17973884469041856","1.0","11","6","3","false","1408","19.0","3","3","false","0","1408","0"
"5.56434929035362","0.0","0.17971553326704423","1.0","11","8","4","false","4273","17.5","4","4","false","0","4273","0"
"5.329564589848449","0.25680909736846924","0.18763258858045587","0.7","11","10","5","false","5259","15.4","5","5","false","0","5259","37803822"
"5.301659850853981","0.566029281704438","0.18862017332909842","0.4642857142857143","11","16","8","false","7355","11.25","8","8","false","0","7355","77811187"
"5.132066394034159","0.6711699222071021","0.19485328583481767","0.5714285714285714","10","14","7","false","9143","15.0","7","7","false","0","9143","112904257"
"5.742843396680298","0.017044442513267873","0.1741297700330918","0.8333333333333334","11","8","4","false","14357","11.25","4","4","false","0","14357","3875130"
"5.551359153235507","0.0","0.18013606621311262","1.0","11","6","3","false","16332","18.333333333333332","3","3","false","0","16332","0"
"5.56386817416406","0.0","0.17973107354403564","1.0","11","4","2","false","19940","23.0","2","2","false","0","19940","0"
"5.550396920856387","1.0196708969956316","0.18016729510683482","0.3333333333333333","11","8","4","false","853","6.75","4","4","false","0","853","95770434"
"5.827760404137599","0.0","0.17159250392140674","0.0","11","2","1","false","8441","16.0","1","1","false","0","8441","0"
"5.827760404137599","0.0","0.17159250392140674","0.0","11","2","1","false","16070","16.0","1","1","false","0","16070","0"
"5.827760404137599","0.0","0.17159250392140674","0.0","11","2","1","false","16087","16.0","1","1","false","0","16087","0"
"5.7394755833533795","0.0","0.1742319460161784","1.0","11","4","2","false","17231","10.0","2","2","false","0","17231","0"
"5.827760404137599","0.0","0.17159250392140674","0.0","11","2","1","false","19434","16.0","1","1","false","0","19434","0"
"5.827760404137599","0.0","0.17159250392140674","0.0","11","2","1","false","23944","16.0","1","1","false","0","23944","0"
"5.827760404137599","0.0","0.17159250392140674","0.0","11","2","1","false","24499","16.0","1","1","false","0","24499","0"
"5.931681501082512","1.4188143321090771","0.1685862600373104","0.42857142857142855","12","14","7","false","10062","5.714285714285714","7","7","false","0","10062","134237829"
"4.940101034399808","0.6005843946528886","0.20242500973899494","0.4","11","12","6","false","23681","14.166666666666666","6","6","false","0","23681","76330468"
"6.057974500841953","0.0","0.16507167533653655","0.0","12","2","1","false","23727","8.0","1","1","false","0","23727","0"
"5.19509261486649","2.5515701448823838","0.19248934987960734","0.4","11","10","5","false","2169","9.6","5","5","false","0","2169","182451668"
"5.215780611017561","0.0","0.19172585554838115","1.0","11","6","3","false","5938","13.0","3","3","false","0","5938","0"
"5.264373346163098","0.0","0.1899561323341254","0.0","11","2","1","false","16084","22.0","1","1","false","0","16084","0"
"5.166706759682463","0.0","0.1935468851848403","1.0","11","6","3","false","18724","12.333333333333334","3","3","false","0","18724","0"
"4.881645417368294","0.9466113217146302","0.20484896269649633","0.6666666666666666","11","8","4","false","18739","16.5","4","4","false","0","18739","149983929"
"5.264373346163098","0.0","0.1899561323341254","0.0","11","2","1","false","19581","22.0","1","1","false","0","19581","0"
"5.166947317777243","0.0","0.19353787420270963","1.0","11","4","2","false","20954","17.0","2","2","false","0","20954","0"
"5.166706759682463","0.0","0.1935468851848403","1.0","11","6","3","false","23991","12.333333333333334","3","3","false","0","23991","0"
"7.309598267981718","0.0","0.13680642401105772","0.0","13","2","1","false","6629","4.0","1","1","false","0","6629","0"
"5.802501804185711","2.1691394054495574","0.1723394552464657","0.3333333333333333","12","12","6","false","8786","4.5","6","6","false","0","8786","193211510"
"6.159008900649507","0.4593983213866153","0.16236378549388744","0.5","12","10","5","false","14078","5.0","5","5","false","0","14078","54593244"
"7.073610777002646","0.0","0.14137051521850028","0.0","12","2","1","false","22088","5.0","1","1","false","0","22088","0"
"6.073851335097426","4.10978814449137","0.16464018376965425","0.1","11","10","5","false","22224","4.4","5","5","false","0","22224","354869602"
"7.073370218907867","0.0","0.14137532308529452","1.0","12","4","2","false","4641","3.5","2","2","false","0","4641","0"
"7.073370218907867","0.0","0.14137532308529452","1.0","12","4","2","false","17937","3.5","2","2","false","0","17937","0"
"7.073610777002646","0.0","0.14137051521850028","0.0","12","2","1","false","21660","5.0","1","1","false","0","21660","0"
"5.45633870579745","0.0","0.1832730799753108","0.0","11","2","1","false","12056","30.0","1","1","false","0","12056","0"
"5.3589126774115945","1.2901440971255984","0.18660501862907933","0.3333333333333333","11","8","4","false","2761","14.5","4","4","false","0","2761","152811449"
"5.2617272071205194","0.0","0.19005166186622777","1.0","10","8","4","false","14647","17.25","4","4","false","0","14647","0"
"6.200866009141207","0.0","0.16126779687318152","1.0","12","6","3","false","4269","6.666666666666667","3","3","false","0","4269","0"
"6.200866009141207","0.0","0.16126779687318152","1.0","12","6","3","false","26159","6.666666666666667","3","3","false","0","26159","0"
"5.408948761125812","3.5206260589665823","0.18487880809428509","0.4666666666666667","11","12","6","false","3066","11.833333333333334","6","6","false","0","3066","284742668"
"5.4471974981958144","0.008653516632234503","0.1835806394629924","0.6666666666666666","11","8","4","false","5434","17.5","4","4","false","0","5434","1049649"
"5.469569401010344","0.0","0.1828297488674847","1.0","11","8","4","false","7991","16.0","4","4","false","0","7991","0"
"5.1900408948761125","25.61893622188408","0.19267670915411356","0.21052631578947367","11","40","20","false","8116","9.4","20","20","false","0","8116","3411747349"
"5.4207361077700265","2.4642536151474617","0.18447679062749622","0.42857142857142855","11","16","8","false","11609","9.875","8","8","false","0","11609","256017859"
"5.554005292278085","0.0","0.18005024255024255","1.0","11","4","2","false","15384","19.5","2","2","false","0","15384","0"
"5.433004570603801","0.0","0.18406021695815805","1.0","11","6","3","false","16946","20.0","3","3","false","0","16946","0"
"5.509742602838585","8.646109253761338","0.18149668180230527","0.19444444444444445","11","18","9","false","17612","6.333333333333333","9","9","false","0","17612","951798881"
"5.454414241039211","2.0283583611765628","0.18333774367116523","0.3333333333333333","11","8","4","false","15528","17.25","4","4","false","0","15528","258741973"
"5.454895357228771","0.0","0.18332157346974776","1.0","11","4","2","false","163","33.5","2","2","false","0","163","0"
"6.453933124849651","0.0","0.15494427671549443","1.0","12","4","2","false","3825","3.0","2","2","false","0","3825","0"
"6.453933124849651","0.0","0.15494427671549443","1.0","12","4","2","false","20893","3.0","2","2","false","0","20893","0"
"5.416165503969209","0.0","0.18463246724405952","1.0","11","6","3","false","10910","27.0","3","3","false","0","10910","0"
"5.265095020447438","2.5725656390875846","0.1899300954904738","0.17857142857142858","11","18","9","false","25777","13.875","9","8","false","1","25777","426846997"
"1.0","0.0","1.0","0.0","1","2","1","false","14771","1.0","1","1","false","0","14771","0"
"1.0","0.0","1.0","0.0","1","2","1","false","24127","1.0","1","1","false","0","24127","0"
"7.616069280731296","0.0","0.13130132659507265","0.0","13","2","1","false","2143","3.0","1","1","false","0","2143","0"
"5.781573249939861","0.5513366198693943","0.17296330198884913","0.5333333333333333","12","30","15","false","12118","9.2","15","15","false","0","12118","69581628"
"5.382487370700024","0.0","0.18578770949720672","1.0","11","6","3","false","15329","14.0","3","3","false","0","15329","0"
"1.0","0.0","1.0","1.0","1","6","3","false","25116","3.0","3","3","false","0","25116","0"
"1.0","0.0","1.0","1.0","1","6","3","false","12689","3.0","3","3","false","0","12689","0"
"1.0","0.0","1.0","1.0","1","6","3","false","17560","3.0","3","3","false","0","17560","0"
"1.0","0.0","1.0","1.0","1","6","3","false","21697","3.0","3","3","false","0","21697","0"
"5.989896560019245","0.0","0.16694779116465863","1.0","11","4","2","false","17599","10.5","2","2","false","0","17599","0"
"5.63098388260765","0.7329148638288571","0.17758885850991113","0.3333333333333333","11","8","4","false","19442","11.5","4","4","false","0","19442","45115244"
"7.306952128939138","0.5000599369362715","0.1368559670781893","0.6666666666666666","13","6","3","false","12419","3.3333333333333335","3","3","false","0","12419","77094842"
"7.306952128939138","0.5000599369362715","0.1368559670781893","0.6666666666666666","13","6","3","false","3507","3.3333333333333335","3","3","false","0","3507","77094842"
"8.30647101274958","0.0","0.12038806834636548","1.0","14","4","2","false","11626","3.0","2","2","false","0","11626","0"
"7.307192687033918","1.0001206842222368","0.1368514616802739","0.0","13","4","2","false","19313","3.0","2","2","false","0","19313","77084284"
"7.307673803223478","0.0","0.13684245177431037","0.0","13","2","1","false","21755","5.0","1","1","false","0","21755","0"
"5.899206158287226","0.0","0.16951433348285283","0.0","11","2","1","false","19356","19.0","1","1","false","0","19356","0"
"1.0","0.0","1.0","0.0","1","2","1","false","23465","1.0","1","1","false","0","23465","0"
"1.0","0.0","1.0","0.0","1","2","1","false","598","1.0","1","1","false","0","598","0"
"7.9251864325234544","0.0","0.12617999696463802","1.0","14","4","2","false","5255","3.0","2","2","false","0","5255","0"
"6.171036805388502","0.0","0.1620473238997388","1.0","12","8","4","false","8864","5.25","4","4","false","0","8864","0"
"6.171036805388502","0.0","0.1620473238997388","1.0","12","8","4","false","16131","5.25","4","4","false","0","16131","0"
"6.171517921578061","0.0","0.16203469109335414","1.0","12","4","2","false","16235","5.5","2","2","false","0","16235","0"
"6.171036805388502","0.0","0.1620473238997388","1.0","12","8","4","false","16280","5.25","4","4","false","0","16280","0"
"6.171036805388502","0.0","0.1620473238997388","1.0","12","8","4","false","17137","5.25","4","4","false","0","17137","0"
"6.171517921578061","0.0","0.16203469109335414","1.0","12","4","2","false","23810","5.5","2","2","false","0","23810","0"
"5.808756314649988","0.0","0.17215389075247445","1.0","12","8","4","false","1728","6.75","4","4","false","0","1728","0"
"5.808756314649988","0.0","0.17215389075247445","1.0","12","8","4","false","5656","6.75","4","4","false","0","5656","0"
"5.8094779889343275","0.0","0.17213250517598344","0.0","12","2","1","false","6082","15.0","1","1","false","0","6082","0"
"5.808756314649988","0.0","0.17215389075247445","1.0","12","8","4","false","18488","6.75","4","4","false","0","18488","0"
"5.808756314649988","0.0","0.17215389075247445","1.0","12","8","4","false","22610","6.75","4","4","false","0","22610","0"
"6.091893192205918","0.0","0.16415258253040593","0.0","11","2","1","false","6390","5.0","1","1","false","0","6390","0"
"9.26292999759442","0.0","0.10795720147509479","0.0","16","2","1","false","5731","2.0","1","1","false","0","5731","0"
"6.364926629781092","3.8069835059985135","0.15711100192751049","0.2","11","10","5","false","6280","3.0","5","5","false","0","6280","276044965"
"7.988934327640125","0.0","0.12517314062029508","1.0","14","4","2","false","1499","4.0","2","2","false","0","1499","0"
"7.988934327640125","0.0","0.12517314062029508","1.0","14","4","2","false","20261","4.0","2","2","false","0","20261","0"
"7.989174885734905","0.0","0.12516937159374905","0.0","14","2","1","false","24002","6.0","1","1","false","0","24002","0"
"7.989174885734905","0.0","0.12516937159374905","0.0","14","2","1","false","23653","6.0","1","1","false","0","23653","0"
"7.629059417849411","9.072111224894497","0.13107775745727437","0.13333333333333333","13","12","6","false","5225","4.0","6","6","false","0","5225","862660184"
"8.627856627375511","1.9240293689251267","0.11590364133162327","0.0","14","6","3","false","3849","2.6666666666666665","3","3","false","0","3849","164945162"
"8.628097185470292","1.2742951520482282","0.11590040984749211","0.3333333333333333","14","6","3","false","7010","3.0","3","3","false","0","7010","109478094"
"8.628097185470292","0.4894853364907644","0.11590040984749211","0.6666666666666666","14","6","3","false","7506","3.6666666666666665","3","3","false","0","7506","83943618"
"8.628097185470292","0.4894853364907644","0.11590040984749211","0.6666666666666666","14","6","3","false","9312","3.6666666666666665","3","3","false","0","9312","83943618"
"8.628337743565071","0.0","0.11589717854354857","1.0","14","4","2","false","20781","4.5","2","2","false","0","20781","0"
"9.627616069280732","0.0","0.10386787267003147","1.0","15","4","2","false","8728","3.0","2","2","false","0","8728","0"
"6.1638200625451045","0.4121305408981667","0.16223705264801155","0.3333333333333333","11","6","3","false","11227","9.0","3","3","false","0","11227","23543781"
"6.007216742843396","1.8921776797101049","0.16646644241550537","0.3333333333333333","11","12","6","false","5862","6.333333333333333","6","6","false","0","5862","104498630"
"6.518402694250661","0.0","0.15341181680628851","1.0","12","4","2","false","7959","9.5","2","2","false","0","7959","0"
"6.1987009862881886","0.0","0.16132412294318535","0.0","12","2","1","false","17569","8.0","1","1","false","0","17569","0"
"6.135193649266298","0.0","0.16299404015056462","1.0","11","6","3","false","18973","5.666666666666667","3","3","false","0","18973","0"
"6.135193649266298","0.0","0.16299404015056462","1.0","11","6","3","false","19207","5.666666666666667","3","3","false","0","19207","0"
"6.134953091171518","0.7218707362582635","0.16300043132180528","0.5","11","8","4","false","19580","4.25","4","4","false","0","19580","52516024"
"9.627616069280732","0.0","0.10386787267003147","0.0","15","2","1","false","3988","3.0","1","1","false","0","3988","0"
"9.627616069280732","0.0","0.10386787267003147","0.0","15","2","1","false","16348","3.0","1","1","false","0","16348","0"
"1.0","0.0","1.0","1.0","1","4","2","false","4017","2.0","2","2","false","0","4017","0"
"1.0","0.0","1.0","1.0","1","4","2","false","7888","2.0","2","2","false","0","7888","0"
"1.0","0.0","1.0","1.0","1","4","2","false","17291","2.0","2","2","false","0","17291","0"
"7.280250180418571","0.0","0.13735791699709224","1.0","13","16","8","false","1008","10.75","8","8","false","0","1008","0"
"7.280250180418571","0.0","0.13735791699709224","1.0","13","16","8","false","2185","10.75","8","8","false","0","2185","0"
"7.28121241279769","0.0","0.1373397647680719","1.0","13","8","4","false","8369","12.5","4","4","false","0","8369","0"
"7.280250180418571","0.0","0.13735791699709224","1.0","13","16","8","false","11824","10.75","8","8","false","0","11824","0"
"7.280250180418571","0.0","0.13735791699709224","1.0","13","16","8","false","12066","10.75","8","8","false","0","12066","0"
"7.28121241279769","0.0","0.1373397647680719","1.0","13","8","4","false","16888","12.5","4","4","false","0","16888","0"
"7.280250180418571","0.0","0.13735791699709224","1.0","13","16","8","false","20808","10.75","8","8","false","0","20808","0"
"7.280250180418571","0.0","0.13735791699709224","1.0","13","16","8","false","21815","10.75","8","8","false","0","21815","0"
"6.232379119557373","0.7771876952798056","0.1604523699243477","0.0","11","4","2","false","1985","3.5","2","2","false","0","1985","61866094"
"5.731296608130863","0.6413421818653376","0.17448058761804827","0.5","11","8","4","false","9763","7.0","4","4","false","0","9763","45895111"
"6.232860235746933","0.0","0.1604399845619452","0.0","11","2","1","false","21657","6.0","1","1","false","0","21657","0"
"7.248255953812846","0.0","0.13796422289336563","1.0","12","4","2","false","16225","5.5","2","2","false","0","16225","0"
"7.247774837623286","2.651043684099758","0.13797338112781704","0.0","12","4","2","false","21404","4.5","2","2","false","0","21404","185677857"
"7.247534279528506","3.5775199039249403","0.13797796070100904","0.4","12","10","5","false","26058","3.4","5","5","false","0","26058","250666884"
"7.687996151070483","0.0","0.1300729059106981","0.0","14","2","1","false","9893","2.0","1","1","false","0","9893","0"
"6.688236709165263","0.951070275146135","0.14951623925475668","0.0","13","4","2","false","20526","2.5","2","2","false","0","20526","74922434"
"7.4734183305268225","2.002187944172926","0.13380757717191874","0.3333333333333333","13","6","3","false","5202","2.6666666666666665","3","3","false","0","5202","136500158"
"5.561222035121482","5.469040228917644","0.17981659313089368","0.0","11","6","3","false","17800","7.666666666666667","3","3","false","0","17800","368545213"
"6.005292278085157","0.0","0.16651978849543342","1.0","12","4","2","false","21995","7.0","2","2","false","0","21995","0"
"7.2167428433966805","0.0","0.13856666666666667","0.0","12","2","1","false","3188","4.0","1","1","false","0","3188","0"
"6.28145297089247","0.9462612548890132","0.15919883578431374","0.5","12","8","4","false","3136","5.0","4","4","false","0","3136","71275701"
"5.970170796247293","1.7017957132065518","0.16749939559996777","0.4","11","10","5","false","9248","7.0","5","5","false","0","9248","105957270"
"7.28121241279769","0.0","0.1373397647680719","0.0","13","2","1","false","11108","4.0","1","1","false","0","11108","0"
"5.418571084917008","7.762900053689326","0.18455049944506102","0.17857142857142858","11","16","8","false","13966","5.875","8","8","false","0","13966","518947573"
"6.267019485205677","1.3791619849677816","0.15956548441578383","0.0","11","4","2","false","4189","5.0","2","2","false","0","4189","114823455"
"6.266778927110897","0.0","0.15957160953514263","1.0","11","4","2","false","16234","6.5","2","2","false","0","16234","0"
"6.267500601395237","0.0","0.1595532355876257","0.0","11","2","1","false","17251","9.0","1","1","false","0","17251","0"
"6.266297810921338","1.884882880158773","0.1595838611846904","0.3333333333333333","11","8","4","false","18373","3.75","4","4","false","0","18373","157246472"
"6.267500601395237","0.0","0.1595532355876257","0.0","11","2","1","false","20557","9.0","1","1","false","0","20557","0"
"7.265816694731778","0.0","0.1376307773804794","1.0","12","4","2","false","19871","3.0","2","2","false","0","19871","0"
"7.265816694731778","0.0","0.1376307773804794","1.0","12","4","2","false","25526","3.0","2","2","false","0","25526","0"
"10.649747414000482","0.0","0.09389894061575298","1.0","17","4","2","false","23786","3.5","2","2","false","0","23786","0"
"10.649747414000482","0.0","0.09389894061575298","1.0","17","4","2","false","25534","3.5","2","2","false","0","25534","0"
"9.651190762569161","0.0","0.10361415752741773","1.0","16","4","2","false","11631","5.0","2","2","false","0","11631","0"
"5.113543420736108","10.766192835873175","0.19555910994025497","0.1323529411764706","11","34","17","false","11861","6.294117647058823","17","17","false","0","11861","880932810"
"5.816454173682945","0.0","0.17192605153232143","1.0","11","4","2","false","18580","9.5","2","2","false","0","18580","0"
"5.816694731777725","0.0","0.17191894127377996","0.0","11","2","1","false","18623","14.0","1","1","false","0","18623","0"
"5.7830165985085396","0.0","0.17292013311148088","1.0","11","6","3","false","20217","7.333333333333333","3","3","false","0","20217","0"
"5.7830165985085396","0.0","0.17292013311148088","1.0","11","6","3","false","25436","7.333333333333333","3","3","false","0","25436","0"
"6.777483762328602","0.0","0.147547384113012","0.0","13","2","1","false","21588","3.0","1","1","false","0","21588","0"
"5.4202549915804665","0.0","0.18449316527605183","0.0","11","2","1","false","17797","31.0","1","1","false","0","17797","0"
"5.0488332932403175","1.5994342901364902","0.19806556127310845","0.4722222222222222","11","18","9","false","1667","16.22222222222222","9","9","false","0","1667","201297649"
"5.417608852537888","2.0866504612163163E-4","0.18458327782958128","0.8571428571428571","11","16","8","false","4258","10.375","8","8","false","0","4258","14420"
"5.418571084917008","0.0","0.18455049944506102","1.0","11","8","4","false","5608","14.75","4","4","false","0","5608","0"
"5.417849410632668","0.0","0.18457508214190568","1.0","11","14","7","false","5771","11.428571428571429","7","7","false","0","5771","0"
"5.417127736348328","1.6407791002942032","0.1845996713886052","0.5333333333333333","11","20","10","false","6675","8.3","10","10","false","0","6675","107717003"
"5.343035843156122","0.0","0.18715951555535545","1.0","11","4","2","false","7386","19.0","2","2","false","0","7386","0"
"5.417849410632668","0.0","0.18457508214190568","1.0","11","14","7","false","16264","11.428571428571429","7","7","false","0","16264","0"
"5.4202549915804665","0.0","0.18449316527605183","0.0","11","2","1","false","17401","31.0","1","1","false","0","17401","0"
"5.417849410632668","0.0","0.18457508214190568","1.0","11","14","7","false","18741","11.428571428571429","7","7","false","0","18741","0"
"5.204714938657686","5.3541057102458485","0.19213348123497873","0.5","11","8","4","false","19895","18.0","4","4","false","0","19895","494839459"
"5.186913639643974","2.8420471992523053","0.1927928763565532","0.3333333333333333","11","8","4","false","20315","12.75","4","4","false","0","20315","196112917"
"4.788068318498918","1.7594118175197098","0.20885249196141478","0.3","11","10","5","false","23741","21.6","5","5","false","0","23741","196045089"
"5.417127736348328","1.6439934681184118","0.1845996713886052","0.5555555555555556","11","20","10","false","25107","8.5","10","10","false","0","25107","107931086"
"5.417849410632668","0.0","0.18457508214190568","1.0","11","14","7","false","25439","11.428571428571429","7","7","false","0","25439","0"
"1.0","0.0","1.0","0.0","1","2","1","false","16281","1.0","1","1","false","0","16281","0"
"1.0","0.0","1.0","0.0","1","2","1","false","24728","1.0","1","1","false","0","24728","0"
"1.0","0.0","1.0","0.0","1","2","1","false","2762","1.0","1","1","false","0","2762","0"
"1.0","0.0","1.0","0.0","1","2","1","false","22378","1.0","1","1","false","0","22378","0"
"5.71710368053885","0.0","0.1749137423209627","0.0","11","2","1","false","9986","13.0","1","1","false","0","9986","0"
"5.71710368053885","0.0","0.1749137423209627","0.0","11","2","1","false","11719","13.0","1","1","false","0","11719","0"
"10.25932162617272","0.0","0.09747233164509472","0.0","17","2","1","false","4467","2.0","1","1","false","0","4467","0"
"9.119797931200385","0.0","0.10965155231990716","0.0","14","2","1","false","21658","3.0","1","1","false","0","21658","0"
"9.119316815010825","0.7497786008872634","0.10965733730776334","0.0","14","4","2","false","23490","2.0","2","2","false","0","23490","63466458"
"1.5","0.0","0.6666666666666666","0.0","2","2","1","false","1669","2.0","1","1","false","0","1669","0"
"1.0","1.5","1.0","0.0","1","4","2","false","12703","1.0","2","2","false","0","12703","3"
"1.5","0.0","0.6666666666666666","0.0","2","2","1","false","5260","2.0","1","1","false","0","5260","0"
"6.04450324753428","0.0","0.1654395669996418","1.0","12","6","3","false","6810","9.0","3","3","false","0","6810","0"
"6.08708203031032","0.0","0.16428232690483718","1.0","11","4","2","false","13636","10.0","2","2","false","0","13636","0"
"5.95790233341352","0.0","0.16784430895950256","1.0","11","4","2","false","16696","12.5","2","2","false","0","16696","0"
"6.04450324753428","0.0","0.1654395669996418","1.0","12","6","3","false","17739","9.0","3","3","false","0","17739","0"
"6.044743805629059","0.0","0.16543298312639287","1.0","12","4","2","false","19605","12.0","2","2","false","0","19605","0"
"6.168390666345923","0.19012127664053852","0.1621168395600967","0.0","12","4","2","false","5838","7.0","2","2","false","0","5838","15848971"
"5.939379360115468","0.01313417326686262","0.16836776022681246","0.6666666666666666","11","6","3","false","11572","9.666666666666666","3","3","false","0","11572","1772784"
"5.983882607649748","0.0","0.16711557788944723","1.0","11","4","2","false","21630","10.5","2","2","false","0","21630","0"
"6.785662737551118","0.0","0.14736954055587068","1.0","12","4","2","false","6073","8.0","2","2","false","0","6073","0"
"6.812845802261246","0.0","0.1467815401998517","1.0","12","4","2","false","9391","7.0","2","2","false","0","9391","0"
"5.484484002886697","0.0","0.18233255844554586","0.0","11","2","1","false","2059","21.0","1","1","false","0","2059","0"
"5.213856146259322","3.8868709244159114","0.19179662268155392","0.09523809523809523","11","14","7","false","11746","8.714285714285714","7","7","false","0","11746","470928192"
"4.857108491700746","0.0","0.20588380961814667","1.0","11","8","4","false","21800","47.5","4","4","false","0","21800","0"
"5.484243444791917","0.0","0.18234055618913939","1.0","11","4","2","false","22372","13.5","2","2","false","0","22372","0"
"5.836901611739235","0.14204589104928778","0.17132377184305966","0.8","11","10","5","false","6465","11.2","5","5","false","0","6465","27882147"
"5.908587923983642","0.0","0.1692451754743099","0.0","11","2","1","false","11563","9.0","1","1","false","0","11563","0"
"5.836901611739235","0.14204589104928778","0.17132377184305966","0.8","11","10","5","false","15891","11.2","5","5","false","0","15891","27882147"
"5.773875390906904","4.868015101159454","0.17319390050829098","0.5947712418300654","11","36","18","false","17385","12.833333333333334","18","18","false","0","17385","645449163"
"7.363002165022853","0.0","0.1358141662310507","0.0","14","2","1","false","1599","6.0","1","1","false","0","1599","0"
"5.823911474621121","0.4806893560451294","0.17170590665014457","0.7142857142857143","12","16","8","false","5812","10.625","8","8","false","0","5812","69803915"
"5.930478710608612","2.142406204237784","0.16862045187198313","0.3333333333333333","13","6","3","false","17248","16.0","3","3","false","0","17248","144914742"
"6.530671157084436","0.7524293126173994","0.15312361868277588","0.3333333333333333","13","6","3","false","20618","6.666666666666667","3","3","false","0","20618","88350266"
"5.824633148905461","0.0","0.17168463222235988","1.0","12","12","6","false","20853","13.0","6","6","false","0","20853","0"
"6.371902814529709","0.0","0.15693899124131683","1.0","12","4","2","false","9392","9.0","2","2","false","0","9392","0"
"6.372143372624489","0.0","0.15693306655592887","0.0","12","2","1","false","24252","14.0","1","1","false","0","24252","0"
"5.67548713014193","5.7465533512243105","0.17619632941974314","0.2857142857142857","11","14","7","false","13422","4.714285714285714","7","7","false","0","13422","323515671"
"5.680298292037527","0.0","0.17604709270317198","0.0","11","2","1","false","16349","11.0","1","1","false","0","16349","0"
"5.811402453692566","2.10378694289635","0.17207550293898502","0.3333333333333333","12","6","3","false","11939","4.666666666666667","3","3","false","0","11939","148162801"
"5.840750541255713","0.0","0.17121087314662276","0.0","12","2","1","false","17191","8.0","1","1","false","0","17191","0"
"5.6685109453933125","0.0","0.17641317263622475","0.0","12","2","1","false","1350","13.0","1","1","false","0","1350","0"
"5.555929757036324","7.200995066016784","0.17998787668860408","0.6133004926108374","11","58","29","false","1023","19.344827586206897","29","29","false","0","1023","706759631"
"5.960789030550878","0.0","0.16776302514225755","0.0","11","2","1","false","1675","12.0","1","1","false","0","1675","0"
"5.684628337743565","0.0","0.17591299564131863","1.0","11","6","3","false","2512","16.333333333333332","3","3","false","0","2512","0"
"5.960548472456098","0.0","0.16776979578658485","1.0","11","4","2","false","3058","7.0","2","2","false","0","3058","0"
"5.960548472456098","0.0","0.16776979578658485","1.0","11","4","2","false","11815","7.0","2","2","false","0","11815","0"
"5.60909309598268","5.945428358696798","0.17828194021529356","0.2857142857142857","11","16","8","false","20924","5.5","8","8","false","0","20924","496551492"
"5.960789030550878","0.0","0.16776302514225755","0.0","11","2","1","false","23420","12.0","1","1","false","0","23420","0"
"5.841712773634833","0.0","0.1711826717180036","1.0","11","4","2","false","19464","6.0","2","2","false","0","19464","0"
"5.841712773634833","0.0","0.1711826717180036","1.0","11","4","2","false","23968","6.0","2","2","false","0","23968","0"
"6.213615588164542","0.0","0.16093689508323655","0.0","12","2","1","false","9597","7.0","1","1","false","0","9597","0"
"6.213375030069762","0.0","0.1609431259437067","1.0","12","4","2","false","11820","4.5","2","2","false","0","11820","0"
"6.213375030069762","0.0","0.1609431259437067","1.0","12","4","2","false","17019","4.5","2","2","false","0","17019","0"
"6.213615588164542","0.0","0.16093689508323655","0.0","12","2","1","false","17121","7.0","1","1","false","0","17121","0"
"5.331248496511908","0.32388684076500474","0.18757332370724664","0.0","11","4","2","false","7811","14.0","2","2","false","0","7811","25378093"
"4.996872744767861","5.006421685663807","0.20012516849605239","0.3333333333333333","11","8","4","false","22269","25.25","4","4","false","0","22269","485611247"
"5.67572768823671","0.0","0.17618886157497668","0.0","11","2","1","false","25272","15.0","1","1","false","0","25272","0"
"5.781332691845081","1.7589522224766463","0.17297049889734947","0.3333333333333333","12","6","3","false","1787","4.666666666666667","3","3","false","0","1787","112659134"
"6.780851575655521","0.0","0.14747410245494535","1.0","13","4","2","false","1279","2.5","2","2","false","0","1279","0"
"6.780851575655521","0.0","0.14747410245494535","1.0","13","4","2","false","14550","2.5","2","2","false","0","14550","0"
"6.2256434929035365","0.026122056360845615","0.16062596599690881","0.4","11","12","6","false","15258","5.666666666666667","6","6","false","0","15258","1573944"
"6.23935530430599","0.0","0.16027296911747696","1.0","11","6","3","false","7071","9.0","3","3","false","0","7071","0"
"6.23911474621121","1.55246383351435","0.16027914867365822","0.3333333333333333","11","8","4","false","8195","6.5","4","4","false","0","8195","110486051"
"6.23887418811643","1.7476561213931623","0.16028532870638135","0.4","11","10","5","false","15951","5.8","5","5","false","0","15951","124529854"
"6.24031753668511","0.0","0.16024825565706796","0.0","11","2","1","false","400","16.0","1","1","false","0","400","0"
"5.833774356507097","0.04153289574782761","0.17141561172735145","0.6666666666666666","11","6","3","false","4379","10.0","3","3","false","0","4379","3867471"
"5.833774356507097","0.0","0.17141561172735145","1.0","11","6","3","false","6541","10.333333333333334","3","3","false","0","6541","0"
"5.8715419773875395","0.0","0.1703130121271714","1.0","11","4","2","false","6905","13.5","2","2","false","0","6905","0"
"5.833774356507097","0.0","0.17141561172735145","1.0","11","6","3","false","8216","10.333333333333334","3","3","false","0","8216","0"
"6.24031753668511","0.0","0.16024825565706796","0.0","11","2","1","false","14498","16.0","1","1","false","0","14498","0"
"7.23839307192687","0.0","0.138152210036557","1.0","12","4","2","false","17502","3.5","2","2","false","0","17502","0"
"7.23839307192687","0.0","0.138152210036557","1.0","12","4","2","false","17740","3.5","2","2","false","0","17740","0"
"6.666827038729854","0.0","0.1499963917153785","1.0","12","4","2","false","5408","6.5","2","2","false","0","5408","0"
"6.666827038729854","0.0","0.1499963917153785","1.0","12","4","2","false","19609","6.5","2","2","false","0","19609","0"
"6.116430117873467","0.9543031874301007","0.1634940611971997","0.0","12","6","3","false","11066","4.333333333333333","3","3","false","0","11066","84328582"
"6.068799615107048","0.0","0.16477723164737593","1.0","12","6","3","false","2340","12.333333333333334","3","3","false","0","2340","0"
"5.550637478951167","4.305520227137778","0.18015948686833666","0.38461538461538464","11","26","13","false","2443","10.153846153846153","13","13","false","0","2443","599941218"
"5.850132306952129","0.0","0.17093630494674947","1.0","11","8","4","false","6918","12.75","4","4","false","0","6918","0"
"5.831609333654077","44.33402423362335","0.17147925088689053","0.8468468468468469","11","74","37","false","7650","32.486486486486484","37","37","false","0","7650","4643844509"
"5.964637960067356","0.0","0.16765476910667473","1.0","12","8","4","false","8184","12.75","4","4","false","0","8184","0"
"5.780370459465961","0.08538692990894466","0.17299929252153648","0.7619047619047619","12","14","7","false","8625","10.285714285714286","7","7","false","0","8625","11403132"
"5.6148664902573975","0.3137148336332992","0.17809862473758623","0.5555555555555556","11","20","10","false","14369","9.1","10","10","false","0","14369","68321348"
"5.301419292759201","4.985303169703441","0.1886287321898539","0.30303030303030304","11","24","12","false","15395","9.0","12","12","false","0","15395","544315174"
"5.780611017560741","0.0","0.17299209321681233","1.0","12","12","6","false","17583","11.833333333333334","6","6","false","0","17583","0"
"6.189559778686553","0.0","0.16156237854644384","1.0","12","4","2","false","25977","13.5","2","2","false","0","25977","0"
"6.406062063988453","1.147339691414206","0.15610214044310927","0.3333333333333333","12","6","3","false","18684","6.666666666666667","3","3","false","0","18684","133136151"
"6.107770026461391","0.20167074735836535","0.16372587632926347","0.5","12","8","4","false","19501","10.75","4","4","false","0","19501","28026405"
"5.824392590810681","0.0","0.1716917231125062","1.0","12","6","3","false","20942","14.0","3","3","false","0","20942","0"
"2.0","1.380952380952381","0.5","0.0","3","4","2","false","17724","2.5","2","2","false","0","17724","58"
"1.4285714285714286","3.5238095238095237","0.7","0.0","2","8","4","false","25957","1.75","4","4","false","0","25957","148"
"2.857142857142857","0.0","0.35","0.0","4","2","1","false","25958","2.0","1","1","false","0","25958","0"
"2.0","1.2142857142857142","0.5","0.0","3","4","2","false","8263","2.5","2","2","false","0","8263","51"
"2.2857142857142856","0.0","0.4375","0.0","3","2","1","false","12046","4.0","1","1","false","0","12046","0"
"2.0","0.9285714285714285","0.5","0.0","3","4","2","false","19126","2.5","2","2","false","0","19126","39"
"5.457541496271349","0.581771496498046","0.18323268832370962","0.4","11","10","5","false","2182","9.0","5","5","false","0","2182","88709113"
"6.2263651671878755","0.0","0.16060734845265234","1.0","12","4","2","false","3553","6.0","2","2","false","0","3553","0"
"5.729372143372625","0.5431285905409412","0.17453919469286644","0.4666666666666667","12","12","6","false","15571","8.166666666666666","6","6","false","0","15571","65498842"
"6.068559057012268","0.06706627863236973","0.1647837634280731","0.6666666666666666","12","6","3","false","10918","5.666666666666667","3","3","false","0","10918","11616092"
"6.448400288669713","0.0","0.1550772215175707","1.0","12","4","2","false","20253","4.0","2","2","false","0","20253","0"
"1.0","0.0","1.0","0.0","1","2","1","false","15388","1.0","1","1","false","0","15388","0"
"1.0","0.0","1.0","0.0","1","2","1","false","15387","1.0","1","1","false","0","15387","0"
"5.992542699061824","0.0","0.16687407169523502","1.0","12","6","3","false","3955","10.0","3","3","false","0","3955","0"
"5.762809718547029","3.217778904423189","0.17352646518617465","0.4909090909090909","12","22","11","false","10532","8.181818181818182","11","11","false","0","10532","470382515"
"6.677892711089728","0.0","0.1497478386167147","1.0","13","14","7","false","7524","8.428571428571429","7","7","false","0","7524","0"
"6.059658407505412","0.5230174801263014","0.16502580389043273","0.8571428571428571","12","16","8","false","8721","8.875","8","8","false","0","8721","124935863"
"6.059658407505412","0.5230174801263014","0.16502580389043273","0.8571428571428571","12","16","8","false","15005","8.875","8","8","false","0","15005","124935863"
"6.383209044984364","2.6129740413255043","0.15666101375541738","0.4888888888888889","13","20","10","false","15372","7.5","10","10","false","0","15372","343146136"
"6.059658407505412","0.5230174801263014","0.16502580389043273","0.8571428571428571","12","16","8","false","16022","8.875","8","8","false","0","16022","124935863"
"6.677892711089728","0.0","0.1497478386167147","1.0","13","14","7","false","18685","8.428571428571429","7","7","false","0","18685","0"
"6.677892711089728","0.0","0.1497478386167147","1.0","13","14","7","false","22083","8.428571428571429","7","7","false","0","22083","0"
"5.937214337262449","0.2670918969049573","0.16842915603095499","0.0","11","4","2","false","22105","12.0","2","2","false","0","22105","33016729"
"9.727207120519605","1.6745297598609718E-4","0.10280443169452963","0.6666666666666666","15","8","4","false","11522","4.0","4","4","false","0","11522","5786"
"8.728650469088285","0.42431001038868305","0.11456524734738872","0.6666666666666666","14","8","4","false","8857","4.5","4","4","false","0","8857","174767110"
"8.728169352898725","2.118832891538398","0.11457156243971006","0.4666666666666667","14","12","6","false","12235","3.6666666666666665","6","6","false","0","12235","523715036"
"9.727447678614386","0.0","0.10280188935875559","1.0","15","6","3","false","22129","4.333333333333333","3","3","false","0","22129","0"
"9.727447678614386","0.0","0.10280188935875559","1.0","15","6","3","false","25387","4.333333333333333","3","3","false","0","25387","0"
"7.730334375751744","5.083465439627442","0.1293605103469737","0.4","13","10","5","false","2826","4.2","5","5","false","0","2826","1222046515"
"8.728891027183066","0.0","0.11456209006228296","1.0","14","6","3","false","23216","5.0","3","3","false","0","23216","0"
"2.0","1.25","0.5","0.0","3","4","2","false","8530","1.5","2","2","false","0","8530","25"
"1.6","2.1","0.625","0.0","2","4","2","false","10906","2.5","2","2","false","0","10906","42"
"2.8","0.0","0.35714285714285715","0.0","4","2","1","false","21144","2.0","1","1","false","0","21144","0"
"6.182583593937936","1.3215465269222477","0.16174467919536203","0.0","12","6","3","false","1073","5.666666666666667","3","3","false","0","1073","111398762"
"6.183545826317055","0.0","0.16171950982299163","0.0","12","2","1","false","18399","15.0","1","1","false","0","18399","0"
"1.0","4.410714285714286","1.0","0.14285714285714285","1","16","8","false","14149","2.0","8","8","false","0","14149","247"
"1.625","0.0","0.6153846153846154","1.0","2","6","3","false","3750","4.666666666666667","3","3","false","0","3750","0"
"1.875","0.0","0.5333333333333333","0.0","2","2","1","false","8147","8.0","1","1","false","0","8147","0"
"1.75","0.0","0.5714285714285714","1.0","2","4","2","false","11616","5.0","2","2","false","0","11616","0"
"1.75","0.0","0.5714285714285714","1.0","2","4","2","false","14662","5.0","2","2","false","0","14662","0"
"1.875","0.0","0.5333333333333333","0.0","2","2","1","false","16648","8.0","1","1","false","0","16648","0"
"1.625","0.0","0.6153846153846154","1.0","2","6","3","false","19560","4.666666666666667","3","3","false","0","19560","0"
"1.875","0.0","0.5333333333333333","0.0","2","2","1","false","22199","8.0","1","1","false","0","22199","0"
"1.625","0.0","0.6153846153846154","1.0","2","6","3","false","23530","4.666666666666667","3","3","false","0","23530","0"
"5.9557373105605","0.0","0.16790532353178772","1.0","11","4","2","false","4289","9.0","2","2","false","0","4289","0"
"6.052201106567236","0.0","0.16522914265272864","0.0","11","2","1","false","9135","11.0","1","1","false","0","9135","0"
"5.95549675246572","0.0","0.16791210566708406","1.0","11","6","3","false","12160","7.0","3","3","false","0","12160","0"
"5.95549675246572","0.0","0.16791210566708406","1.0","11","6","3","false","19809","7.0","3","3","false","0","19809","0"
"5.755592975703633","0.0","0.17374404413608627","0.0","11","2","1","false","4027","12.0","1","1","false","0","4027","0"
"5.336300216502285","0.0","0.18739575350493623","1.0","11","8","4","false","7450","11.5","4","4","false","0","7450","0"
"5.663459225402935","0.0","0.17657053051862548","1.0","12","6","3","false","836","11.0","3","3","false","0","836","0"
"5.662978109213375","2.6020028255736176","0.17658553162567436","0.4","12","10","5","false","16747","7.0","5","5","false","0","16747","193489951"
"5.644455135915323","1.6249643780442764","0.17716501875213092","0.4","12","10","5","false","18193","8.2","5","5","false","0","18193","127155392"
"5.935770988693769","0.0","0.16847011144883486","0.0","11","2","1","false","9095","10.0","1","1","false","0","9095","0"
"5.935289872504209","0.0","0.16848376768127105","1.0","11","4","2","false","12043","6.5","2","2","false","0","12043","0"
"5.935770988693769","0.0","0.16847011144883486","0.0","11","2","1","false","18742","10.0","1","1","false","0","18742","0"
"5.93504931440943","1.1538414164171753","0.16849059662775615","0.3333333333333333","11","6","3","false","22890","4.333333333333333","3","3","false","0","22890","94559548"
"5.935770988693769","0.0","0.16847011144883486","0.0","11","2","1","false","26044","10.0","1","1","false","0","26044","0"
"6.519846042819341","0.8278704235790459","0.1533778548500166","0.0","12","6","3","false","8876","5.666666666666667","3","3","false","0","8876","102704116"
"7.519605484724561","0.0","0.1329857001183659","0.0","13","2","1","false","10990","3.0","1","1","false","0","10990","0"
"5.474380562905941","0.0","0.18266906885793383","1.0","11","10","5","false","4255","12.4","5","5","false","0","4255","0"
"5.4741400048111615","0.21935936725093583","0.18267709615046582","0.8666666666666667","11","12","6","false","4771","10.833333333333334","6","6","false","0","4771","66643623"
"5.4741400048111615","0.21935936725093583","0.18267709615046582","0.8666666666666667","11","12","6","false","5251","10.833333333333334","6","6","false","0","5251","66643623"
"5.463555448640847","1.4008162530636954","0.18303099682986967","0.5277777777777778","11","18","9","false","18256","8.555555555555555","9","9","false","0","18256","241607515"
"5.463555448640847","1.4008162530636954","0.18303099682986967","0.5277777777777778","11","18","9","false","18337","8.555555555555555","9","9","false","0","18337","241607515"
"5.542458503728651","0.5631749200011206","0.18042534722222223","0.3333333333333333","11","6","3","false","20236","5.666666666666667","3","3","false","0","20236","36184179"
"1.5","0.0","0.6666666666666666","1.0","2","4","2","false","11279","3.0","2","2","false","0","11279","0"
"1.5","0.0","0.6666666666666666","1.0","2","4","2","false","9832","3.0","2","2","false","0","9832","0"
"1.0","2.1666666666666665","1.0","0.16666666666666666","1","8","4","false","17750","1.5","4","4","false","0","17750","26"
"1.75","0.0","0.5714285714285714","0.0","2","2","1","false","22976","4.0","1","1","false","0","22976","0"
"1.75","0.0","0.5714285714285714","0.0","2","2","1","false","25609","4.0","1","1","false","0","25609","0"
"5.708684147221554","0.0","0.17517171632042478","1.0","12","4","2","false","124","18.0","2","2","false","0","124","0"
"5.8265576136637","0.0","0.17162792617976136","1.0","12","6","3","false","14319","12.333333333333334","3","3","false","0","14319","0"
"5.8270387298532595","0.0","0.1716137555216117","0.0","12","2","1","false","15663","26.0","1","1","false","0","15663","0"
"5.82679817175848","0.0","0.17162084055817026","1.0","12","4","2","false","16937","14.0","2","2","false","0","16937","0"
"5.817175847967284","0.0","0.17190472252088332","1.0","12","6","3","false","18052","16.0","3","3","false","0","18052","0"
"5.82679817175848","0.0","0.17162084055817026","1.0","12","4","2","false","20258","14.0","2","2","false","0","20258","0"
"6.559297570363243","0.0","0.15245534895661422","0.0","13","2","1","false","9151","4.0","1","1","false","0","9151","0"
"6.559297570363243","0.0","0.15245534895661422","0.0","13","2","1","false","25856","4.0","1","1","false","0","25856","0"
"6.288429155641087","0.0","0.15902222562258522","1.0","13","8","4","false","2047","7.5","4","4","false","0","2047","0"
"6.288429155641087","0.0","0.15902222562258522","1.0","13","8","4","false","3632","7.5","4","4","false","0","3632","0"
"6.288429155641087","0.0","0.15902222562258522","1.0","13","8","4","false","15383","7.5","4","4","false","0","15383","0"
"5.899687274476786","0.9503998904865784","0.1695005096839959","0.34545454545454546","12","22","11","false","24385","5.454545454545454","11","11","false","0","24385","113435131"
"5.646860716863123","5.436225529025725","0.17708954588054868","0.20512820512820512","11","26","13","false","3716","5.461538461538462","13","13","false","0","3716","416611408"
"5.901371181140245","0.006504525625233815","0.1694521441382684","0.8333333333333334","12","8","4","false","8391","10.25","4","4","false","0","8391","1187804"
"6.288669713735867","0.0","0.1590161426057685","1.0","13","6","3","false","14497","9.0","3","3","false","0","14497","0"
"5.901130623045465","0.08706899684829258","0.169459051811993","0.7","12","10","5","false","24101","8.8","5","5","false","0","24101","12852284"
"6.645176810199663","0.0","0.15048508543295686","1.0","12","6","3","false","2388","9.0","3","3","false","0","2388","0"
"6.645176810199663","0.0","0.15048508543295686","1.0","12","6","3","false","16955","9.0","3","3","false","0","16955","0"
"5.531392831368776","0.0","0.1807862920761938","0.0","11","2","1","false","12981","47.0","1","1","false","0","12981","0"
"6.45657926389223","0.0","0.15488077496274216","1.0","12","4","2","false","19642","9.0","2","2","false","0","19642","0"
"6.560500360837143","1.3505769574054731","0.15242739806394837","0.3333333333333333","12","6","3","false","7592","6.666666666666667","3","3","false","0","7592","127357557"
"6.609574212172239","0.0","0.15129567622652498","0.0","12","2","1","false","8179","12.0","1","1","false","0","8179","0"
"5.787827760404138","0.0","0.17277639235245218","1.0","11","4","2","false","7579","9.0","2","2","false","0","7579","0"
"5.6774115949001684","0.43851476614433055","0.1761366043811703","0.3333333333333333","11","6","3","false","21653","9.333333333333334","3","3","false","0","21653","42832998"
"6.113302862641328","0.0","0.1635776964545705","0.0","12","2","1","false","5542","17.0","1","1","false","0","5542","0"
"5.504209766658648","0.12381099838404301","0.18167912241597833","0.8333333333333334","11","8","4","false","4080","12.25","4","4","false","0","4080","18772076"
"6.112821746451768","0.0","0.16359057101255361","1.0","12","6","3","false","14747","8.333333333333334","3","3","false","0","14747","0"
"6.113302862641328","0.0","0.1635776964545705","0.0","12","2","1","false","17463","17.0","1","1","false","0","17463","0"
"5.504209766658648","0.12381099838404301","0.18167912241597833","0.8333333333333334","11","8","4","false","19324","12.25","4","4","false","0","19324","18772076"
"5.1375992302140965","10.995945014123567","0.19464344243105305","0.23636363636363636","11","22","11","false","20567","15.545454545454545","11","11","false","0","20567","848426993"
"6.112581188356988","0.0","0.1635970090515545","1.0","12","8","4","false","21550","7.25","4","4","false","0","21550","0"
"6.112581188356988","0.0","0.1635970090515545","1.0","12","8","4","false","24220","7.25","4","4","false","0","24220","0"
"6.113302862641328","0.0","0.1635776964545705","0.0","12","2","1","false","25179","17.0","1","1","false","0","25179","0"
"6.112581188356988","0.0","0.1635970090515545","1.0","12","8","4","false","25553","7.25","4","4","false","0","25553","0"
"6.112581188356988","0.0","0.1635970090515545","1.0","12","8","4","false","25554","7.25","4","4","false","0","25554","0"
"6.643733461630984","0.0","0.1505177782605547","1.0","12","4","2","false","11468","4.0","2","2","false","0","11468","0"
"6.643733461630984","0.0","0.1505177782605547","1.0","12","4","2","false","11470","4.0","2","2","false","0","11470","0"
"6.643492903536204","6.97768968376219E-5","0.15052322844624688","0.6666666666666666","12","6","3","false","17804","3.0","3","3","false","0","17804","2411"
"6.0442626894395","0.0","0.1654461513969593","1.0","12","4","2","false","17294","10.0","2","2","false","0","17294","0"
"5.982439259081068","0.0","0.1671558968997547","1.0","12","6","3","false","2309","7.666666666666667","3","3","false","0","2309","0"
"5.982439259081068","0.0","0.1671558968997547","1.0","12","6","3","false","6532","7.666666666666667","3","3","false","0","6532","0"
"6.04450324753428","0.0","0.1654395669996418","0.0","12","2","1","false","8553","16.0","1","1","false","0","8553","0"
"2.3333333333333335","0.0","0.42857142857142855","0.0","3","2","1","false","4633","5.0","1","1","false","0","4633","0"
"2.3333333333333335","0.0","0.42857142857142855","0.0","3","2","1","false","11593","5.0","1","1","false","0","11593","0"
"2.3333333333333335","0.0","0.42857142857142855","0.0","3","2","1","false","16818","5.0","1","1","false","0","16818","0"
"2.3333333333333335","0.0","0.42857142857142855","0.0","3","2","1","false","23648","5.0","1","1","false","0","23648","0"
"6.687274476786144","0.0","0.14953775315658835","0.0","13","2","1","false","939","13.0","1","1","false","0","939","0"
"6.687033918691364","0.0","0.14954313259946758","1.0","13","4","2","false","1834","7.5","2","2","false","0","1834","0"
"6.687033918691364","0.0","0.14954313259946758","1.0","13","4","2","false","5056","7.5","2","2","false","0","5056","0"
"6.6858311282174645","2.0445752528927748","0.14957003562048","0.4","13","10","5","false","13664","4.6","5","5","false","0","13664","215379484"
"6.687274476786144","0.0","0.14953775315658835","0.0","13","2","1","false","14037","13.0","1","1","false","0","14037","0"
"6.686312244407024","0.0","0.14955927325058463","1.0","13","6","3","false","16940","7.0","3","3","false","0","16940","0"
"6.686312244407024","0.0","0.14955927325058463","1.0","13","6","3","false","19613","7.0","3","3","false","0","19613","0"
"6.3911474621121","0.0","0.15646642577536887","0.0","11","2","1","false","16335","6.0","1","1","false","0","16335","0"
"6.76160692807313","0.0","0.1478938380532233","0.0","11","2","1","false","6913","3.0","1","1","false","0","6913","0"
"6.115949001683907","0.0","0.16350692259282568","1.0","12","8","4","false","3594","13.0","4","4","false","0","3594","0"
"5.8708203031032","0.029508565543881097","0.1703339479614833","0.8","12","10","5","false","10024","12.4","5","5","false","0","10024","7907679"
"6.115949001683907","0.0","0.16350692259282568","1.0","12","8","4","false","23713","13.0","4","4","false","0","23713","0"
"5.002886697137359","0.09297455562145417","0.19988459874020292","0.7","11","10","5","false","10376","15.4","5","5","false","0","10376","16281946"
"5.050998316093336","4.158793465229455E-4","0.1979806639043673","0.6666666666666666","11","8","4","false","15325","16.25","4","4","false","0","15325","71998"
"6.08539812364686","0.0","0.16432778590346683","1.0","12","6","3","false","20344","9.333333333333334","3","3","false","0","20344","0"
"6.08539812364686","0.0","0.16432778590346683","1.0","12","6","3","false","2001","9.0","3","3","false","0","2001","0"
"6.08563868174164","0.0","0.1643212902205708","1.0","12","4","2","false","3633","11.5","2","2","false","0","3633","0"
"7.2169834014914604","0.0","0.1385620479317356","0.0","13","2","1","false","23064","2.0","1","1","false","0","23064","0"
"1.0","0.0","1.0","1.0","1","4","2","false","5083","2.0","2","2","false","0","5083","0"
"1.0","0.0","1.0","1.0","1","4","2","false","5084","2.0","2","2","false","0","5084","0"
"1.0","0.0","1.0","1.0","1","4","2","false","8711","2.0","2","2","false","0","8711","0"
"6.337503006976185","1.449670569696672","0.15779085215410893","0.3333333333333333","13","6","3","false","12712","8.333333333333334","3","3","false","0","12712","121986942"
"6.471012749579024","1.2878141581057079","0.1545353159851301","0.0","13","4","2","false","14324","9.0","2","2","false","0","14324","102016605"
"6.249458744286745","0.04664387657984682","0.16001385734631818","0.6","12","12","6","false","21409","9.0","6","6","false","0","21409","8157256"
"6.69569401010344","0.055455048683054745","0.14934971617446288","0.4","12","10","5","false","17124","6.4","5","5","false","0","17124","6947899"
"6.984363723839307","0.0","0.1431769649376593","0.0","14","2","1","false","25719","8.0","1","1","false","0","25719","0"
"5.87033918691364","0.09770761422445266","0.17034790804409294","0.6797385620915033","11","36","18","false","8261","14.5","18","18","false","0","8261","29530870"
"5.8713014192927595","0.04249890601293963","0.17031999016675542","0.7692307692307693","11","28","14","false","11464","15.785714285714286","14","14","false","0","11464","18340261"
"5.8713014192927595","0.04249890601293963","0.17031999016675542","0.7692307692307693","11","28","14","false","17997","15.785714285714286","14","14","false","0","17997","18340261"
"5.875390906904017","0.0","0.17020144120537178","1.0","11","14","7","false","20662","15.0","7","7","false","0","20662","0"
"5.875390906904017","0.0","0.17020144120537178","1.0","11","14","7","false","22837","15.0","7","7","false","0","22837","0"
"6.737070002405581","0.7620824875790756","0.1484324787545526","0.3333333333333333","13","6","3","false","2316","2.3333333333333335","3","3","false","0","2316","52671918"
"7.736829444310801","0.0","0.12925191219451526","0.0","14","2","1","false","11929","3.0","1","1","false","0","11929","0"
"1.0","0.0","1.0","1.0","1","4","2","false","350","2.0","2","2","false","0","350","0"
"1.0","0.0","1.0","1.0","1","4","2","false","951","2.0","2","2","false","0","951","0"
"1.0","0.0","1.0","1.0","1","4","2","false","25676","2.0","2","2","false","0","25676","0"
"6.381284580226125","0.0","0.15670825950917933","0.0","12","2","1","false","2532","5.0","1","1","false","0","2532","0"
"5.2703872985325955","3.4924694200009974","0.18973937651193573","0.2222222222222222","11","18","9","false","14067","5.777777777777778","9","9","false","0","14067","207872613"
"6.009141207601636","0.7570328513450532","0.1664131305044035","0.0","11","4","2","false","20086","4.5","2","2","false","0","20086","46619638"
"5.771950926148665","0.0","0.17325164624489456","1.0","11","6","3","false","21772","7.666666666666667","3","3","false","0","21772","0"
"7.008900649506856","0.0","0.1426757276221856","0.0","12","2","1","false","15715","2.0","1","1","false","0","15715","0"
"1.0","0.0","1.0","0.0","1","2","1","false","925","1.0","1","1","false","0","925","0"
"1.0","0.0","1.0","0.0","1","2","1","false","8615","1.0","1","1","false","0","8615","0"
"5.980274236228049","2.584361487341002","0.16721641190667738","0.3333333333333333","12","8","4","false","6506","7.0","4","4","false","0","6506","182962735"
"5.8636035602598024","8.880725871730736","0.17054358974358974","0.17777777777777778","12","20","10","false","9037","5.6","10","10","false","0","9037","741577081"
"6.040894876112581","0.0","0.16553838802166296","0.0","12","2","1","false","13483","12.0","1","1","false","0","13483","0"
"6.040894876112581","0.0","0.16553838802166296","0.0","12","2","1","false","14711","12.0","1","1","false","0","14711","0"
"6.040654318017801","0.0","0.1655449802875234","1.0","12","4","2","false","23623","7.5","2","2","false","0","23623","0"
"7.530430598989656","0.0","0.132794531050345","0.0","14","2","1","false","23686","3.0","1","1","false","0","23686","0"
"6.178494106326678","0.0","0.16185173648964335","0.0","11","2","1","false","864","9.0","1","1","false","0","864","0"
"5.665383690161174","0.0","0.1765105515689355","1.0","11","6","3","false","1311","9.333333333333334","3","3","false","0","1311","0"
"5.665383690161174","0.0","0.1765105515689355","1.0","11","6","3","false","3983","9.333333333333334","3","3","false","0","3983","0"
"6.0312725523213855","1.1756694760045108","0.16580248883216336","0.3333333333333333","11","6","3","false","26013","6.666666666666667","3","3","false","0","26013","74822163"
"2.857142857142857","0.0","0.35","0.0","4","2","1","false","17882","2.0","1","1","false","0","17882","0"
"10.119076256916046","0.0","0.09882324973255675","0.0","15","2","1","false","18379","2.0","1","1","false","0","18379","0"
"6.165022853019004","0.2607700024705815","0.16220540034337444","0.3333333333333333","11","8","4","false","18217","4.0","4","4","false","0","18217","19022787"
"6.446475823911475","0.0","0.1551235166803493","1.0","11","4","2","false","26173","4.0","2","2","false","0","26173","0"
"7.708924705316334","0.6076848239793124","0.12971977781938462","0.0","13","4","2","false","21297","3.5","2","2","false","0","21297","56757432"
"5.959345681982199","0.0","0.16780365720744359","1.0","12","4","2","false","18447","5.0","2","2","false","0","18447","0"
"5.3502525859995185","0.0","0.18690706353131606","1.0","11","4","2","false","21165","24.0","2","2","false","0","21165","0"
"7.319701707962473","0.0","0.1366175890627054","1.0","13","6","3","false","4988","5.666666666666667","3","3","false","0","4988","0"
"7.319701707962473","0.0","0.1366175890627054","1.0","13","6","3","false","17125","5.666666666666667","3","3","false","0","17125","0"
"6.428193408708203","0.19081650668617173","0.1555647032407754","0.0","11","4","2","false","9913","5.5","2","2","false","0","9913","10979230"
"7.230454654799134","0.0","0.1383038892770403","0.0","12","2","1","false","22382","6.0","1","1","false","0","22382","0"
"6.4106326677892715","0.0","0.15599084393410634","1.0","11","4","2","false","17884","5.5","2","2","false","0","17884","0"
"6.4106326677892715","0.0","0.15599084393410634","1.0","11","4","2","false","20538","5.5","2","2","false","0","20538","0"
"6.136155881645418","0.0","0.1629684804767132","1.0","11","4","2","false","24032","8.5","2","2","false","0","24032","0"
"5.935770988693769","0.06783265517436184","0.16847011144883486","0.5333333333333333","12","12","6","false","2009","6.833333333333333","6","6","false","0","2009","10538431"
"6.34832812124128","0.0","0.15752178855627133","0.0","12","2","1","false","7309","13.0","1","1","false","0","7309","0"
"6.34832812124128","0.0","0.15752178855627133","0.0","12","2","1","false","8156","13.0","1","1","false","0","8156","0"
"5.936011546788549","0.03390082082346471","0.16846328416274922","0.7","12","10","5","false","8403","8.0","5","5","false","0","8403","5269434"
"6.440942987731537","0.0","0.15525676937441643","0.0","12","2","1","false","16011","11.0","1","1","false","0","16011","0"
"6.440942987731537","0.0","0.15525676937441643","0.0","12","2","1","false","22929","11.0","1","1","false","0","22929","0"
"6.440942987731537","0.0","0.15525676937441643","0.0","12","2","1","false","22993","11.0","1","1","false","0","22993","0"
"5.5792638922299735","0.0","0.17923511404303022","1.0","11","6","3","false","8732","10.333333333333334","3","3","false","0","8732","0"
"5.561222035121482","5.545559422595744","0.17981659313089368","0.3333333333333333","11","8","4","false","10022","9.5","4","4","false","0","10022","346627073"
"4.932162617272072","0.12087359572326108","0.20275081695361652","0.4","11","12","6","false","14932","14.5","6","6","false","0","14932","11833313"
"5.5792638922299735","0.0","0.17923511404303022","1.0","11","6","3","false","16659","10.333333333333334","3","3","false","0","16659","0"
"5.5792638922299735","0.0","0.17923511404303022","1.0","11","6","3","false","22377","10.333333333333334","3","3","false","0","22377","0"
"6.612942025499158","0.7284753177902088","0.15121862495452892","0.3","13","10","5","false","22806","3.2","5","5","false","0","22806","107641006"
"7.612701467404378","0.0","0.13135941351197625","0.0","14","2","1","false","14809","5.0","1","1","false","0","14809","0"
"6.613663699783498","0.0","0.15120212417706325","1.0","13","4","2","false","22953","6.5","2","2","false","0","22953","0"
"6.613663699783498","0.0","0.15120212417706325","1.0","13","4","2","false","23950","6.5","2","2","false","0","23950","0"
"6.15371662256435","0.0","0.16250342050740785","0.0","12","2","1","false","18489","4.0","1","1","false","0","18489","0"
"6.97834977146981","0.723371272362468","0.14330035506222205","0.0","13","4","2","false","95","3.0","2","2","false","0","95","44419915"
"7.97810921337503","0.0","0.12534298205939998","0.0","14","2","1","false","15524","2.0","1","1","false","0","15524","0"
"6.3856146259321624","0.013341344048584364","0.156601996609531","0.6666666666666666","11","6","3","false","3291","9.666666666666666","3","3","false","0","3291","1831161"
"7.229492422420014","0.0","0.1383222972748145","0.0","12","2","1","false","12696","6.0","1","1","false","0","12696","0"
"7.134712533076738","0.0","0.14015981658181328","0.0","12","2","1","false","14869","4.0","1","1","false","0","14869","0"
"6.2966081308636035","0.0","0.15881566380133716","1.0","13","8","4","false","6190","7.25","4","4","false","0","6190","0"
"6.2966081308636035","0.0","0.15881566380133716","1.0","13","8","4","false","10656","7.25","4","4","false","0","10656","0"
"6.069280731296608","0.0","0.16476416963931828","1.0","12","4","2","false","11002","11.5","2","2","false","0","11002","0"
"6.2966081308636035","0.0","0.15881566380133716","1.0","13","8","4","false","11403","7.25","4","4","false","0","11403","0"
"6.069280731296608","0.0","0.16476416963931828","1.0","12","4","2","false","20106","11.5","2","2","false","0","20106","0"
"5.708443589126774","0.05807431550714435","0.17517909818794775","0.3333333333333333","12","6","3","false","24060","12.0","3","3","false","0","24060","11125024"
"6.2966081308636035","0.0","0.15881566380133716","1.0","13","8","4","false","25610","7.25","4","4","false","0","25610","0"
"6.140004811161895","0.0","0.1628663218931202","1.0","13","6","3","false","22693","10.333333333333334","3","3","false","0","22693","0"
"6.140004811161895","0.0","0.1628663218931202","1.0","13","6","3","false","23920","10.333333333333334","3","3","false","0","23920","0"
"5.5708443589126775","0.19766659424983174","0.17950600224544433","0.4888888888888889","12","20","10","false","4458","11.3","10","10","false","0","4458","23643366"
"6.340149146018764","0.0","0.15772499620579755","1.0","13","6","3","false","5547","10.0","3","3","false","0","5547","0"
"6.340149146018764","0.0","0.15772499620579755","1.0","13","6","3","false","5659","10.0","3","3","false","0","5659","0"
"6.1635795044503245","0.0","0.1622433845913668","1.0","13","6","3","false","7883","11.0","3","3","false","0","7883","0"
"5.764012509020929","0.0","0.1734902549977046","1.0","12","4","2","false","8387","25.0","2","2","false","0","8387","0"
"6.340149146018764","0.0","0.15772499620579755","1.0","13","6","3","false","12313","10.0","3","3","false","0","12313","0"
"6.340149146018764","0.0","0.15772499620579755","1.0","13","6","3","false","15160","10.0","3","3","false","0","15160","0"
"6.340149146018764","0.0","0.15772499620579755","1.0","13","6","3","false","19325","10.0","3","3","false","0","19325","0"
"6.1635795044503245","0.0","0.1622433845913668","1.0","13","6","3","false","21205","11.0","3","3","false","0","21205","0"
"6.340149146018764","0.0","0.15772499620579755","1.0","13","6","3","false","22831","10.0","3","3","false","0","22831","0"
"1.0","2.6666666666666665","1.0","0.0","1","6","3","false","1556","1.0","3","3","false","0","1556","16"
"1.6666666666666667","0.0","0.6","0.0","2","2","1","false","11965","3.0","1","1","false","0","11965","0"
"1.6666666666666667","0.0","0.6","0.0","2","2","1","false","14096","3.0","1","1","false","0","14096","0"
"1.6666666666666667","0.0","0.6","0.0","2","2","1","false","23154","3.0","1","1","false","0","23154","0"
"7.505171999037768","0.0","0.13324145004647583","0.0","13","2","1","false","15191","2.0","1","1","false","0","15191","0"
"1.0","0.0","1.0","1.0","1","8","4","false","5212","4.0","4","4","false","0","5212","0"
"1.0","0.0","1.0","1.0","1","8","4","false","6628","4.0","4","4","false","0","6628","0"
"1.0","0.0","1.0","1.0","1","8","4","false","19015","4.0","4","4","false","0","19015","0"
"1.0","0.0","1.0","1.0","1","8","4","false","19444","4.0","4","4","false","0","19444","0"
"1.0","0.0","1.0","1.0","1","8","4","false","25139","4.0","4","4","false","0","25139","0"
"9.06591291796969","0.0","0.11030328760580571","0.0","14","2","1","false","9441","2.0","1","1","false","0","9441","0"
"8.06615347606447","0.7014911360477578","0.12397482926247354","0.0","13","4","2","false","10388","2.5","2","2","false","0","10388","83951353"
"5.602116911234063","0.22592082343606207","0.17850395053246307","0.6666666666666666","12","8","4","false","8222","5.75","4","4","false","0","8222","28383789"
"5.377916766899206","1.0250125835520838","0.18594560744319197","0.4","11","10","5","false","21495","5.4","5","5","false","0","21495","105613850"
"7.488092374308396","0.0","0.13354536108969417","1.0","13","4","2","false","6807","4.5","2","2","false","0","6807","0"
"5.8186191965359635","0.0","0.17186208037043163","1.0","11","6","3","false","2075","7.333333333333333","3","3","false","0","2075","0"
"5.8188597546307435","0.0","0.17185497540204225","1.0","11","4","2","false","3873","9.5","2","2","false","0","3873","0"
"5.8186191965359635","0.0","0.17186208037043163","1.0","11","6","3","false","4182","7.333333333333333","3","3","false","0","4182","0"
"5.8186191965359635","0.0","0.17186208037043163","1.0","11","6","3","false","10439","7.333333333333333","3","3","false","0","10439","0"
"6.341351936492663","0.0","0.15769507985281286","0.0","13","2","1","false","14619","9.0","1","1","false","0","14619","0"
"5.8987250420976665","0.0","0.16952815953672362","1.0","11","8","4","false","2044","7.25","4","4","false","0","2044","0"
"5.8987250420976665","0.0","0.16952815953672362","1.0","11","8","4","false","4490","7.25","4","4","false","0","4490","0"
"5.515034880923743","0.3468743111819475","0.18132251592078863","0.6","11","12","6","false","17001","8.5","6","6","false","0","17001","42833454"
"5.515034880923743","0.3468743111819475","0.18132251592078863","0.6","11","12","6","false","18013","8.5","6","6","false","0","18013","42833454"
"5.754390185229733","0.0","0.17378036035282807","1.0","11","6","3","false","9147","11.0","3","3","false","0","9147","0"
"5.740197257637719","1.0495048605418618","0.17421004106948287","0.3","11","10","5","false","24398","9.4","5","5","false","0","24398","112273687"
"7.305989896560019","0.00840112432016897","0.13687399163675876","0.6666666666666666","14","6","3","false","5216","4.333333333333333","3","3","false","0","5216","794050"
"7.350012027904739","0.0","0.13605419912286443","0.0","14","2","1","false","17290","6.0","1","1","false","0","17290","0"
"7.349771469809959","0.0","0.13605865217818217","1.0","14","4","2","false","20155","4.5","2","2","false","0","20155","0"
"6.838585518402694","0.0","0.1462290699310539","0.0","13","2","1","false","1045","5.0","1","1","false","0","1045","0"
"6.838585518402694","0.0","0.1462290699310539","0.0","13","2","1","false","6265","5.0","1","1","false","0","6265","0"
"6.720471493865769","0.0","0.14879908365250386","0.0","13","2","1","false","5402","6.0","1","1","false","0","5402","0"
"6.720471493865769","0.0","0.14879908365250386","0.0","13","2","1","false","15947","6.0","1","1","false","0","15947","0"
"7.273033437575174","0.0","0.13749421181451346","0.0","13","2","1","false","2203","7.0","1","1","false","0","2203","0"
"7.273033437575174","0.0","0.13749421181451346","0.0","13","2","1","false","7594","7.0","1","1","false","0","7594","0"
"6.745248977628097","4.07325196573471","0.1482524964336662","0.2","12","10","5","false","21130","4.0","5","5","false","0","21130","358283002"
"7.736588886216021","0.0","0.12925593109666988","0.0","13","2","1","false","21615","15.0","1","1","false","0","21615","0"
"6.646620158768343","0.0","0.15045240680419833","0.0","12","2","1","false","2622","5.0","1","1","false","0","2622","0"
"5.887178253548232","0.0","0.16986066277121725","1.0","11","4","2","false","4960","10.5","2","2","false","0","4960","0"
"6.047630502766418","0.3755780204374892","0.1653540175019889","0.5714285714285714","12","14","7","false","16270","6.0","7","7","false","0","16270","72369067"
"6.599951888381044","0.0","0.1515162560139962","1.0","13","8","4","false","16102","7.0","4","4","false","0","16102","0"
"6.088525378878999","0.13968168296094738","0.16424338206242592","0.7","12","10","5","false","17956","6.6","5","5","false","0","17956","28085046"
"6.088765936973779","0.0","0.1642368930504524","1.0","12","8","4","false","20375","7.5","4","4","false","0","20375","0"
"6.599951888381044","0.0","0.1515162560139962","1.0","13","8","4","false","22463","7.0","4","4","false","0","22463","0"
"6.600192446475824","0.0","0.151510733680796","1.0","13","6","3","false","3878","7.0","3","3","false","0","3878","0"
"6.599951888381044","0.0035300424627730895","0.1515162560139962","0.6666666666666666","13","8","4","false","16584","6.25","4","4","false","0","16584","629385"
"7.316093336540774","0.33699839064550835","0.1366849702429882","0.6666666666666666","12","6","3","false","2997","4.666666666666667","3","3","false","0","2997","51237566"
"7.316093336540774","0.33699839064550835","0.1366849702429882","0.6666666666666666","12","6","3","false","6888","4.666666666666667","3","3","false","0","6888","51237566"
"8.315612220351214","0.0","0.12025572784077761","1.0","13","4","2","false","11664","3.0","2","2","false","0","11664","0"
"6.142650950204475","0.0","0.16279616213040923","0.0","11","2","1","false","4712","6.0","1","1","false","0","4712","0"
"6.142650950204475","0.0","0.16279616213040923","0.0","11","2","1","false","11017","6.0","1","1","false","0","11017","0"
"1.3333333333333333","0.0","0.75","1.0","2","4","2","false","7632","2.5","2","2","false","0","7632","0"
"1.3333333333333333","0.0","0.75","1.0","2","4","2","false","14170","2.5","2","2","false","0","14170","0"
"1.0","1.5","1.0","0.3333333333333333","1","6","3","false","20414","1.6666666666666667","3","3","false","0","20414","9"
"1.6666666666666667","0.0","0.6","0.0","2","2","1","false","11427","3.0","1","1","false","0","11427","0"
"6.343757517440462","9.374303015382212","0.15763528118008419","0.13333333333333333","11","12","6","false","5240","3.3333333333333335","6","6","false","0","5240","645314085"
"7.341351936492663","2.305687288831552","0.1362146929680844","0.3333333333333333","12","8","4","false","9074","3.5","4","4","false","0","9074","157512762"
"7.3408708203031035","4.908332027126803","0.13622362039585792","0.3333333333333333","12","8","4","false","12425","4.0","4","4","false","0","12425","335523935"
"7.343516959345682","0.0","0.1361745340190651","0.0","12","2","1","false","18275","6.0","1","1","false","0","18275","0"
"6.697618474861679","0.0","0.14930680267222182","1.0","12","4","2","false","20636","6.0","2","2","false","0","20636","0"
"6.441905220110657","0.0","0.1552335785503566","1.0","12","6","3","false","4640","7.333333333333333","3","3","false","0","4640","0"
"6.441905220110657","0.0","0.1552335785503566","1.0","12","6","3","false","19248","7.333333333333333","3","3","false","0","19248","0"
"6.9785903295645895","0.0","0.14329541537400897","1.0","13","4","2","false","11109","3.5","2","2","false","0","11109","0"
"6.9785903295645895","0.0","0.14329541537400897","1.0","13","4","2","false","21562","3.5","2","2","false","0","21562","0"
"6.300697618474862","4.025701513941603E-5","0.158712583995113","0.6666666666666666","12","6","3","false","21149","5.333333333333333","3","3","false","0","21149","1391"
"6.300938176569642","0.0","0.15870652464398885","1.0","12","4","2","false","312","7.5","2","2","false","0","312","0"
"6.300938176569642","0.0","0.15870652464398885","1.0","12","4","2","false","16545","7.5","2","2","false","0","16545","0"
"5.509742602838585","1.594543486230432","0.18149668180230527","0.6","11","12","6","false","12786","9.333333333333334","6","6","false","0","12786","255079659"
"5.5090209285542455","5.155451221434955","0.18152045762193791","0.42857142857142855","11","14","7","false","13673","8.285714285714286","7","7","false","0","13673","542220365"
"1.6666666666666667","0.0","0.6","0.0","2","2","1","false","7958","3.0","1","1","false","0","7958","0"
"1.0","1.8333333333333333","1.0","0.3333333333333333","1","6","3","false","25130","1.6666666666666667","3","3","false","0","25130","11"
"1.3333333333333333","0.0","0.75","1.0","2","4","2","false","14543","2.5","2","2","false","0","14543","0"
"1.3333333333333333","0.0","0.75","1.0","2","4","2","false","21221","2.5","2","2","false","0","21221","0"
"7.116189559778687","0.0","0.14052464336420795","0.0","13","2","1","false","9266","3.0","1","1","false","0","9266","0"
"7.182343035843156","0.0","0.13923033124560405","0.0","13","2","1","false","2750","3.0","1","1","false","0","2750","0"
"7.182343035843156","0.0","0.13923033124560405","0.0","13","2","1","false","20668","3.0","1","1","false","0","20668","0"
"7.056290594178494","0.0","0.14171751951726724","0.0","12","2","1","false","3068","5.0","1","1","false","0","3068","0"
"7.056050036083715","0.0","0.14172235101595526","1.0","12","4","2","false","5631","3.5","2","2","false","0","5631","0"
"7.056050036083715","0.0","0.14172235101595526","1.0","12","4","2","false","16067","3.5","2","2","false","0","16067","0"
"7.056290594178494","0.0","0.14171751951726724","0.0","12","2","1","false","19569","5.0","1","1","false","0","19569","0"
"7.04209766658648","0.0","0.14200314272050285","1.0","12","4","2","false","2917","4.5","2","2","false","0","2917","0"
"7.04209766658648","0.0","0.14200314272050285","1.0","12","4","2","false","6031","4.5","2","2","false","0","6031","0"
"7.0418571084917","0.0","0.14200799371434428","1.0","12","6","3","false","2010","4.333333333333333","3","3","false","0","2010","0"
"7.0418571084917","0.0","0.14200799371434428","1.0","12","6","3","false","8064","4.333333333333333","3","3","false","0","8064","0"
"7.0418571084917","0.0","0.14200799371434428","1.0","12","6","3","false","20599","4.333333333333333","3","3","false","0","20599","0"
"5.779167668992062","0.0","0.17303529803529802","1.0","12","6","3","false","179","15.333333333333334","3","3","false","0","179","0"
"5.799615107048353","0.0","0.1724252353892737","1.0","12","10","5","false","547","12.6","5","5","false","0","547","0"
"5.799374548953573","7.854603816561835E-5","0.172432387589182","0.8","12","12","6","false","1829","10.833333333333334","6","6","false","0","1829","4071"
"5.800096223237912","0.0","0.17241093276927544","1.0","12","6","3","false","1982","17.333333333333332","3","3","false","0","1982","0"
"5.5215299494828","0.17506014226271593","0.18110922319522502","0.7","11","10","5","false","3178","13.4","5","5","false","0","3178","16482856"
"5.799855665143132","0.0","0.1724180837826628","1.0","12","8","4","false","4989","14.25","4","4","false","0","4989","0"
"5.799615107048353","0.0","0.1724252353892737","1.0","12","10","5","false","18870","12.6","5","5","false","0","18870","0"
"5.618715419773875","0.2383969976656687","0.17797662371023676","0.5","11","8","4","false","20062","11.75","4","4","false","0","20062","25829568"
"5.800096223237912","0.0","0.17241093276927544","1.0","12","6","3","false","22464","16.0","3","3","false","0","22464","0"
"7.32571566033197","1.970487469331158","0.13650543460414408","0.0","13","6","3","false","6878","1.6666666666666667","3","3","false","0","6878","212722170"
"8.32499398604763","0.6642251216277008","0.1201202068945589","0.0","14","4","2","false","11528","2.0","2","2","false","0","11528","71726281"
"8.32547510223719","0.0","0.12011326533560635","0.0","14","2","1","false","22244","3.0","1","1","false","0","22244","0"
"6.386336300216502","0.0","0.15658430013560343","1.0","11","4","2","false","11812","6.0","2","2","false","0","11812","0"
"5.8987250420976665","0.0","0.16952815953672362","1.0","12","4","2","false","24248","7.5","2","2","false","0","24248","0"
"5.072648544623527","1.6721232869030433","0.19713567600891543","0.3333333333333333","11","6","3","false","8122","17.666666666666668","3","3","false","0","8122","133216993"
"5.081789752225163","0.0","0.1967810650887574","1.0","11","6","3","false","9769","18.0","3","3","false","0","9769","0"
"5.082270868414722","0.0","0.19676243669238416","0.0","11","2","1","false","15253","45.0","1","1","false","0","15253","0"
"5.074332451286986","2.995937395608396","0.19707025694510288","0.3333333333333333","11","6","3","false","16647","18.333333333333332","3","3","false","0","16647","208730185"
"5.081789752225163","0.0","0.1967810650887574","1.0","11","6","3","false","22489","18.0","3","3","false","0","22489","0"
"5.082270868414722","0.0","0.19676243669238416","0.0","11","2","1","false","23412","45.0","1","1","false","0","23412","0"
"5.082270868414722","0.0","0.19676243669238416","0.0","11","2","1","false","25443","45.0","1","1","false","0","25443","0"
"5.970411354342073","1.849048139851653","0.16749264676256095","0.42857142857142855","12","16","8","false","8511","4.875","8","8","false","0","8511","129969579"
"6.058936733221073","0.0","0.1650454599595029","1.0","12","4","2","false","22503","5.5","2","2","false","0","22503","0"
"6.743805629059418","0.0","0.1482842262966398","0.0","12","2","1","false","13604","2.0","1","1","false","0","13604","0"
"6.646139042578783","0.0","0.1504632981033734","1.0","12","6","3","false","4704","6.666666666666667","3","3","false","0","4704","0"
"6.645898484484003","7.136865516448593E-5","0.15046874434430085","0.6666666666666666","12","8","4","false","8801","5.25","4","4","false","0","8801","2466"
"6.646139042578783","0.0","0.1504632981033734","1.0","12","6","3","false","12695","6.666666666666667","3","3","false","0","12695","0"
"6.046187154197739","0.027286777539426984","0.16539349088883584","0.6666666666666666","12","6","3","false","15125","11.333333333333334","3","3","false","0","15125","2421624"
"6.646379600673563","0.0","0.1504578522566868","1.0","12","4","2","false","15420","8.5","2","2","false","0","15420","0"
"5.800577339427472","0.0","0.17239663252187618","0.0","12","2","1","false","25204","26.0","1","1","false","0","25204","0"
"5.433485686793361","0.20072086778311435","0.1840439190684907","0.5333333333333333","10","12","6","false","385","10.5","6","6","false","0","385","27437097"
"5.442145778205437","0.0","0.18375104981655835","1.0","10","4","2","false","1323","23.5","2","2","false","0","1323","0"
"5.427231176329084","0.14157675911693188","0.18425601702052213","0.6","10","10","5","false","1606","12.2","5","5","false","0","1606","18911559"
"5.855184026942506","0.0","0.1707888249794577","1.0","11","6","3","false","7072","14.0","3","3","false","0","7072","0"
"5.855665143132066","0.0","0.17077479253964342","0.0","11","2","1","false","9890","32.0","1","1","false","0","9890","0"
"5.815973057493385","0.0","0.1719402738139554","1.0","11","6","3","false","12849","14.333333333333334","3","3","false","0","12849","0"
"5.441905220110657","0.0","0.18375917248695958","1.0","10","6","3","false","14377","17.666666666666668","3","3","false","0","14377","0"
"5.816935289872505","0.0","0.1719118316033249","1.0","11","4","2","false","17981","21.5","2","2","false","0","17981","0"
"5.855184026942506","0.0","0.1707888249794577","1.0","11","6","3","false","18234","14.0","3","3","false","0","18234","0"
"5.463074332451287","8.420391566987849","0.1830471158080141","0.10909090909090909","11","22","11","false","21220","7.909090909090909","11","11","false","0","21220","699872867"
"5.442145778205437","0.0","0.18375104981655835","1.0","10","4","2","false","22225","23.5","2","2","false","0","22225","0"
"5.431080105845561","7.858973385627843","0.18412543739203616","0.2","10","10","5","false","23506","12.2","5","5","false","0","23506","686535017"
"5.318498917488573","0.3623487471213521","0.1880229770681623","0.6666666666666666","10","8","4","false","23620","15.0","4","4","false","0","23620","57720823"
"5.620158768342555","0.0","0.17793091640628345","1.0","11","6","3","false","24332","17.333333333333332","3","3","false","0","24332","0"
"1.8","0.0","0.5555555555555556","1.0","3","4","2","false","376","3.5","2","2","false","0","376","0"
"1.2","1.05","0.8333333333333334","0.5","2","8","4","false","2611","2.75","4","4","false","0","2611","32"
"1.4","0.4","0.7142857142857143","0.6666666666666666","2","6","3","false","16620","3.3333333333333335","3","3","false","0","16620","16"
"1.2","1.6","0.8333333333333334","0.3333333333333333","2","8","4","false","1908","2.5","4","4","false","0","1908","44"
"1.6","0.0","0.625","1.0","2","4","2","false","16621","4.0","2","2","false","0","16621","0"
"6.04378157324994","0.0","0.16545932176405032","1.0","12","4","2","false","12106","9.5","2","2","false","0","12106","0"
"5.886937695453452","0.0","0.16986760379208893","1.0","12","8","4","false","1267","16.25","4","4","false","0","1267","0"
"5.685350012027905","1.2625928921218497","0.1758906659896759","0.3333333333333333","12","6","3","false","1511","10.333333333333334","3","3","false","0","1511","103292244"
"5.840269425066153","3.30939909000502","0.17122497734574513","0.4","12","10","5","false","15793","6.0","5","5","false","0","15793","313817783"
"5.886937695453452","0.0","0.16986760379208893","1.0","12","8","4","false","18102","16.25","4","4","false","0","18102","0"
"5.799615107048353","0.0","0.1724252353892737","1.0","12","6","3","false","20772","10.666666666666666","3","3","false","0","20772","0"
"6.117151792157806","0.0","0.163474772897086","0.0","12","2","1","false","23248","14.0","1","1","false","0","23248","0"
"5.660331970170796","1.0001505451511077","0.17666808329791756","0.4","12","10","5","false","26193","7.8","5","5","false","0","26193","97023804"
"1.0","0.0","1.0","1.0","1","4","2","false","10872","2.0","2","2","false","0","10872","0"
"1.0","0.0","1.0","1.0","1","4","2","false","2666","2.0","2","2","false","0","2666","0"
"1.0","0.0","1.0","1.0","1","4","2","false","24250","2.0","2","2","false","0","24250","0"
"1.0","0.0","1.0","1.0","1","4","2","false","9630","2.0","2","2","false","0","9630","0"
"1.0","0.0","1.0","1.0","1","4","2","false","10252","2.0","2","2","false","0","10252","0"
"1.0","0.0","1.0","1.0","1","4","2","false","16820","2.0","2","2","false","0","16820","0"
"6.378638441183546","0.6007372329984583","0.15677326896967866","0.0","11","4","2","false","22830","5.0","2","2","false","0","22830","72041831"
"1.3333333333333333","0.0","0.75","1.0","2","4","2","false","14159","2.5","2","2","false","0","14159","0"
"1.3333333333333333","0.0","0.75","1.0","2","4","2","false","5144","2.5","2","2","false","0","5144","0"
"1.0","2.1666666666666665","1.0","0.3333333333333333","1","6","3","false","24852","1.6666666666666667","3","3","false","0","24852","13"
"1.6666666666666667","0.0","0.6","0.0","2","2","1","false","8869","3.0","1","1","false","0","8869","0"
"7.120760163579504","1.1362598673045368","0.14043444478227088","0.3","13","10","5","false","299","3.4","5","5","false","0","299","76632778"
"7.158046668270387","0.0","0.13970291705874446","1.0","13","4","2","false","14174","5.5","2","2","false","0","14174","0"
"7.947558335337984","0.0","0.12582480779708216","1.0","14","4","2","false","18746","5.0","2","2","false","0","18746","0"
"7.4378157324993985","0.5055558990810356","0.13444807399980593","0.3","14","10","5","false","22051","2.8","5","5","false","0","22051","39852650"
"7.947558335337984","0.0","0.12582480779708216","1.0","14","4","2","false","22075","5.0","2","2","false","0","22075","0"
"6.162617272071206","4.472348930451064","0.1622687173081427","0.2","12","12","6","false","24713","5.5","6","6","false","0","24713","301202222"
"7.625691604522492","0.0","0.13113564668769717","1.0","14","4","2","false","14616","4.0","2","2","false","0","14616","0"
"6.678373827279288","1.4617087872524477","0.14973705064476622","0.3333333333333333","13","6","3","false","17817","4.0","3","3","false","0","17817","123040557"
"6.2605244166466205","0.0","0.159731027857829","0.0","12","2","1","false","2356","8.0","1","1","false","0","2356","0"
"5.949001683906664","2.728417632076036","0.16809543065103114","0.28888888888888886","11","20","10","false","6337","4.7","10","10","false","0","6337","193812441"
"5.692326196776522","8.435423923667924","0.17567510459366945","0.25","11","16","8","false","17419","6.625","8","8","false","0","17419","902146015"
"6.255472696656242","0.0","0.15986002153514844","1.0","12","4","2","false","18105","9.0","2","2","false","0","18105","0"
"6.639403415924946","0.0","0.1506159420289855","1.0","12","10","5","false","2773","7.0","5","5","false","0","2773","0"
"6.948761125811884","0.0","0.1439105449006439","0.0","12","2","1","false","5661","10.0","1","1","false","0","5661","0"
"6.639403415924946","0.0","0.1506159420289855","1.0","12","10","5","false","6529","7.0","5","5","false","0","6529","0"
"6.639403415924946","0.0","0.1506159420289855","1.0","12","10","5","false","6543","7.0","5","5","false","0","6543","0"
"6.691363964397402","0.0","0.14944636180615473","1.0","12","4","2","false","16486","9.0","2","2","false","0","16486","0"
"6.2879480394515275","0.09211751851404058","0.15903439305252687","0.0","12","4","2","false","8523","3.5","2","2","false","0","8523","6377357"
"7.405580947798893","3.3716335469029246E-4","0.135033295436089","0.6","13","10","5","false","19964","4.0","5","5","false","0","19964","11650"
"7.406302622083233","0.0","0.13502013771599325","1.0","13","6","3","false","2342","5.0","3","3","false","0","2342","0"
"7.406062063988453","0.0","0.13502452333777243","1.0","13","6","3","false","2516","5.0","3","3","false","0","2516","0"
"7.405821505893673","1.1813081035200896","0.13502890924446176","0.5","13","8","4","false","21998","3.75","4","4","false","0","21998","117340689"
"5.395477507818138","0.9606514274255653","0.18534040750813677","0.6111111111111112","11","18","9","false","941","8.11111111111111","9","9","false","0","941","81593500"
"5.568198219870099","0.0","0.17959130772886334","1.0","11","14","7","false","13712","8.428571428571429","7","7","false","0","13712","0"
"5.568198219870099","0.0","0.17959130772886334","1.0","11","14","7","false","16727","8.428571428571429","7","7","false","0","16727","0"
"5.568198219870099","0.0","0.17959130772886334","1.0","11","14","7","false","22321","8.428571428571429","7","7","false","0","22321","0"
"5.568198219870099","0.0","0.17959130772886334","1.0","11","14","7","false","23383","8.428571428571429","7","7","false","0","23383","0"
"5.0221313447197495","4.664273773781947","0.1991186473152273","0.75","11","16","8","false","25442","16.875","8","8","false","0","25442","467904474"
"6.075775799855665","0.0","0.16458803500019795","1.0","12","16","8","false","19980","11.25","8","8","false","0","19980","0"
"6.074332451286986","6.671493263794523E-4","0.16462714347946616","0.6043956043956044","12","28","14","false","5957","9.428571428571429","14","14","false","0","5957","34578"
"6.075775799855665","0.0","0.16458803500019795","1.0","12","16","8","false","7716","11.25","8","8","false","0","7716","0"
"6.075775799855665","0.0","0.16458803500019795","1.0","12","16","8","false","11233","11.25","8","8","false","0","11233","0"
"6.075775799855665","0.0","0.16458803500019795","1.0","12","16","8","false","14090","11.25","8","8","false","0","14090","0"
"6.075775799855665","0.0","0.16458803500019795","1.0","12","16","8","false","18397","11.25","8","8","false","0","18397","0"
"6.075775799855665","0.0","0.16458803500019795","1.0","12","16","8","false","25541","11.25","8","8","false","0","25541","0"
"6.075775799855665","0.0","0.16458803500019795","1.0","12","16","8","false","2249","11.25","8","8","false","0","2249","0"
"6.075775799855665","0.0","0.16458803500019795","1.0","12","16","8","false","6077","11.25","8","8","false","0","6077","0"
"6.075775799855665","0.0","0.16458803500019795","1.0","12","16","8","false","6611","11.25","8","8","false","0","6611","0"
"6.075775799855665","0.0","0.16458803500019795","1.0","12","16","8","false","8672","11.25","8","8","false","0","8672","0"
"6.075775799855665","0.0","0.16458803500019795","1.0","12","16","8","false","19955","11.25","8","8","false","0","19955","0"
"6.075775799855665","0.0","0.16458803500019795","1.0","12","16","8","false","21832","11.25","8","8","false","0","21832","0"
"6.076978590329564","1.4634178049571638","0.16455545879186131","0.0","12","4","2","false","3316","11.0","2","2","false","0","3316","103575881"
"6.077459706519124","0.0","0.16454243191893603","0.0","12","2","1","false","9759","21.0","1","1","false","0","9759","0"
"6.077459706519124","0.0","0.16454243191893603","0.0","12","2","1","false","11865","21.0","1","1","false","0","11865","0"
"1.5","0.0","0.6666666666666666","0.0","2","2","1","false","3199","2.0","1","1","false","0","3199","0"
"1.0","1.5","1.0","0.0","1","4","2","false","19507","1.0","2","2","false","0","19507","3"
"1.5","0.0","0.6666666666666666","0.0","2","2","1","false","12798","2.0","1","1","false","0","12798","0"
"9.969689680057733","0.0","0.10030402470803977","0.0","17","2","1","false","855","4.0","1","1","false","0","855","0"
"9.969689680057733","0.0","0.10030402470803977","0.0","17","2","1","false","4261","4.0","1","1","false","0","4261","0"
"9.969689680057733","0.0","0.10030402470803977","0.0","17","2","1","false","7772","4.0","1","1","false","0","7772","0"
"5.781092133750301","0.0","0.1729776964047936","0.0","11","2","1","false","23299","10.0","1","1","false","0","23299","0"
"6.364686071686312","0.0","0.1571169400559377","1.0","13","4","2","false","8871","3.5","2","2","false","0","8871","0"
"6.364686071686312","0.0","0.1571169400559377","1.0","13","4","2","false","17090","3.5","2","2","false","0","17090","0"
"7.378397883088766","0.0","0.13553077725612936","0.0","12","2","1","false","3772","2.0","1","1","false","0","3772","0"
"5.6069280731296605","0.0","0.17835078084777758","1.0","11","8","4","false","4104","10.0","4","4","false","0","4104","0"
"5.6069280731296605","0.0","0.17835078084777758","1.0","11","8","4","false","4431","10.0","4","4","false","0","4431","0"
"5.656242482559538","0.0","0.17679581508101902","1.0","11","4","2","false","4967","13.0","2","2","false","0","4967","0"
"5.656001924464758","0.0","0.17680333446750596","1.0","11","6","3","false","11152","10.0","3","3","false","0","11152","0"
"5.656001924464758","0.0","0.17680333446750596","1.0","11","6","3","false","15616","10.0","3","3","false","0","15616","0"
"5.656483040654318","0.0","0.17678829633409884","0.0","11","2","1","false","16262","24.0","1","1","false","0","16262","0"
"5.6069280731296605","0.0","0.17835078084777758","1.0","11","8","4","false","18995","10.0","4","4","false","0","18995","0"
"5.096944912196295","1.5523301670087135","0.19619595997734568","0.8571428571428571","11","14","7","false","19562","18.428571428571427","7","7","false","0","19562","417851403"
"5.62978109213375","0.0","0.17762679998290817","1.0","11","6","3","false","22087","11.0","3","3","false","0","22087","0"
"5.656242482559538","0.0","0.17679581508101902","1.0","11","4","2","false","22109","13.0","2","2","false","0","22109","0"
"5.62978109213375","0.0","0.17762679998290817","1.0","11","6","3","false","22839","11.0","3","3","false","0","22839","0"
"5.656001924464758","0.0","0.17680333446750596","1.0","11","6","3","false","23683","10.0","3","3","false","0","23683","0"
"5.096944912196295","1.5523301670087135","0.19619595997734568","0.8571428571428571","11","14","7","false","24477","18.428571428571427","7","7","false","0","24477","417851403"
"5.867933605965841","1.574912430366321","0.17041774279506416","0.3333333333333333","12","8","4","false","25304","6.75","4","4","false","0","25304","241106441"
"5.882607649747414","0.5899256631496718","0.16999263924102395","0.3333333333333333","12","6","3","false","14854","6.333333333333333","3","3","false","0","14854","117033400"
"5.917729131585278","3.9522271404797404","0.16898373983739837","0.14285714285714285","12","14","7","false","24489","4.142857142857143","7","7","false","0","24489","458892789"
"6.882367091652634","0.0","0.14529884655714784","0.0","13","2","1","false","6835","3.0","1","1","false","0","6835","0"
"6.232860235746933","0.22055648013297702","0.1604399845619452","0.0","12","4","2","false","24219","6.5","2","2","false","0","24219","24871284"
"6.6410873225884055","0.0","0.15057775201941537","1.0","12","6","3","false","3321","10.333333333333334","3","3","false","0","3321","0"
"6.582631705556892","0.0","0.15191492471860837","1.0","12","26","13","false","1151","14.76923076923077","13","13","false","0","1151","0"
"6.582631705556892","0.0","0.15191492471860837","1.0","12","26","13","false","2410","14.76923076923077","13","13","false","0","2410","0"
"6.43613182583594","2.1347508463144447","0.15537282750887685","0.543859649122807","12","38","19","false","3843","11.947368421052632","19","19","false","0","3843","355253378"
"6.582631705556892","0.0","0.15191492471860837","1.0","12","26","13","false","6301","14.76923076923077","13","13","false","0","6301","0"
"6.6415684387779645","0.0","0.1505668441450252","0.0","12","2","1","false","10247","21.0","1","1","false","0","10247","0"
"6.582631705556892","0.0","0.15191492471860837","1.0","12","26","13","false","15414","14.76923076923077","13","13","false","0","15414","0"
"6.582631705556892","0.0","0.15191492471860837","1.0","12","26","13","false","18743","14.76923076923077","13","13","false","0","18743","0"
"6.582631705556892","0.0","0.15191492471860837","1.0","12","26","13","false","22032","14.76923076923077","13","13","false","0","22032","0"
"6.437094058215059","0.20545980237989073","0.15534960200306439","0.8095238095238095","12","30","15","false","22903","14.333333333333334","15","15","false","0","22903","35010011"
"6.582631705556892","0.0","0.15191492471860837","1.0","12","26","13","false","23674","14.76923076923077","13","13","false","0","23674","0"
"6.582631705556892","0.0","0.15191492471860837","1.0","12","26","13","false","24294","14.76923076923077","13","13","false","0","24294","0"
"6.582631705556892","0.0","0.15191492471860837","1.0","12","26","13","false","24706","14.76923076923077","13","13","false","0","24706","0"
"6.437094058215059","0.20545980237989073","0.15534960200306439","0.8095238095238095","12","30","15","false","25998","14.333333333333334","15","15","false","0","25998","35010011"
"7.298532595621842","0.0","0.1370138431114041","0.0","12","2","1","false","2124","2.0","1","1","false","0","2124","0"
"5.8183786384411835","0.0","0.17186918592632405","1.0","12","4","2","false","3293","7.5","2","2","false","0","3293","0"
"6.89078662496993","1.3217885853055058","0.1451213126200035","0.0","12","8","4","false","5825","2.75","4","4","false","0","5825","126816812"
"7.89054606687515","0.0","0.12673394103838298","0.0","13","2","1","false","628","4.0","1","1","false","0","628","0"
"7.3052682222756795","0.08478950705377253","0.13688751317175976","0.0","13","4","2","false","9413","3.0","2","2","false","0","9413","5489747"
"7.89054606687515","0.0","0.12673394103838298","0.0","13","2","1","false","13641","4.0","1","1","false","0","13641","0"
"6.388982439259081","0.5059834686545758","0.15651944726834593","0.0","12","4","2","false","1962","7.0","2","2","false","0","1962","44787500"
"6.67356266538369","0.0","0.14984500036046428","1.0","12","8","4","false","1613","5.75","4","4","false","0","1613","0"
"6.67356266538369","0.0","0.14984500036046428","1.0","12","8","4","false","13992","5.75","4","4","false","0","13992","0"
"6.67356266538369","0.0","0.14984500036046428","1.0","12","8","4","false","15217","5.75","4","4","false","0","15217","0"
"6.67524657204715","0.0","0.1498072002594688","0.0","12","2","1","false","15665","7.0","1","1","false","0","15665","0"
"6.672600433004571","2.293058336148334","0.14986660898406517","0.2857142857142857","12","16","8","false","16154","3.375","8","8","false","0","16154","129035208"
"6.67524657204715","0.0","0.1498072002594688","0.0","12","2","1","false","21159","7.0","1","1","false","0","21159","0"
"7.672119316815011","0.0","0.1303420813344621","1.0","13","4","2","false","915","5.0","2","2","false","0","915","0"
"7.672119316815011","0.0","0.1303420813344621","1.0","13","4","2","false","10438","5.0","2","2","false","0","10438","0"
"7.672119316815011","0.0","0.1303420813344621","1.0","13","4","2","false","18624","5.0","2","2","false","0","18624","0"
"7.672119316815011","0.0","0.1303420813344621","1.0","13","4","2","false","20558","5.0","2","2","false","0","20558","0"
"5.953572287707481","0.0","0.1679663824801002","1.0","12","4","2","false","10026","7.0","2","2","false","0","10026","0"
"5.602357469328843","0.04962459361451597","0.17849628580016316","0.6666666666666666","11","6","3","false","15316","14.0","3","3","false","0","15316","6337966"
"5.921818619196536","0.0","0.16886704310029654","0.0","12","2","1","false","17249","11.0","1","1","false","0","17249","0"
"7.9557373105605","0.0","0.12569545234639576","1.0","13","6","3","false","18066","5.666666666666667","3","3","false","0","18066","0"
"7.9557373105605","0.0","0.12569545234639576","1.0","13","6","3","false","12787","5.666666666666667","3","3","false","0","12787","0"
"7.485927351455376","0.37419304204504106","0.1335839840611845","0.4","13","12","6","false","21621","5.166666666666667","6","6","false","0","21621","57250251"
"6.95669954293962","2.118346177184012","0.14374632594488052","0.25","12","16","8","false","24877","4.5","8","8","false","0","24877","199232350"
"6.67500601395237","0.8837785386273292","0.1498125991062419","0.5","12","10","5","false","93","5.8","5","5","false","0","93","154979277"
"7.95597786865528","0.0","0.1256916518005624","1.0","13","4","2","false","17343","7.0","2","2","false","0","17343","0"
"6.642771229251864","4.9172504459024715","0.15053958137176796","0.2222222222222222","12","20","10","false","20328","4.3","10","10","false","0","20328","517368861"
"7.102237190281453","0.0","0.14080070451158377","1.0","13","4","2","false","9103","8.0","2","2","false","0","9103","0"
"7.486889583834496","0.0","0.13356681553834784","1.0","13","4","2","false","10684","9.0","2","2","false","0","10684","0"
"8.373586721193169","0.0","0.11942313769427446","0.0","14","2","1","false","11878","3.0","1","1","false","0","11878","0"
"8.373105605003609","0.5641983337821127","0.11942999971270146","0.0","14","4","2","false","18557","2.0","2","2","false","0","18557","36303869"
"9.372865046908828","0.0","0.10669096322151786","0.0","15","2","1","false","21101","2.0","1","1","false","0","21101","0"
"7.450805869617513","0.0","0.13421366997061956","1.0","13","4","2","false","19909","3.5","2","2","false","0","19909","0"
"7.450805869617513","0.0","0.13421366997061956","1.0","13","4","2","false","23474","3.5","2","2","false","0","23474","0"
"7.6331489054606685","0.0","0.13100753206643345","1.0","13","4","2","false","7093","6.5","2","2","false","0","7093","0"
"7.6331489054606685","0.0","0.13100753206643345","1.0","13","4","2","false","8000","6.5","2","2","false","0","8000","0"
"7.6333894635554485","0.0","0.13100340350434891","0.0","13","2","1","false","17395","10.0","1","1","false","0","17395","0"
"7.6333894635554485","0.0","0.13100340350434891","0.0","13","2","1","false","18582","10.0","1","1","false","0","18582","0"
"7.6329083473658885","1.487570509105668E-5","0.13101166088874883","0.6666666666666666","13","6","3","false","22375","4.666666666666667","3","3","false","0","22375","514"
"7.6333894635554485","0.0","0.13100340350434891","0.0","13","2","1","false","23419","10.0","1","1","false","0","23419","0"
"1.0","0.0","1.0","0.0","1","2","1","false","2593","1.0","1","1","false","0","2593","0"
"1.0","0.0","1.0","0.0","1","2","1","false","10433","1.0","1","1","false","0","10433","0"
"6.051238874188116","2.130062051948972E-4","0.16525541641820712","0.8476190476190476","12","30","15","false","3231","16.133333333333333","15","15","false","0","3231","29440"
"6.052201106567236","0.0","0.16522914265272864","1.0","12","22","11","false","4705","17.0","11","11","false","0","4705","0"
"6.051238874188116","2.130062051948972E-4","0.16525541641820712","0.8476190476190476","12","30","15","false","4773","16.133333333333333","15","15","false","0","4773","29440"
"6.051238874188116","2.130062051948972E-4","0.16525541641820712","0.8476190476190476","12","30","15","false","6411","16.133333333333333","15","15","false","0","6411","29440"
"6.052201106567236","0.0","0.16522914265272864","1.0","12","22","11","false","8549","17.0","11","11","false","0","8549","0"
"6.8636035602598024","0.0","0.14569606056357776","1.0","12","8","4","false","10500","9.0","4","4","false","0","10500","0"
"6.051238874188116","2.130062051948972E-4","0.16525541641820712","0.8476190476190476","12","30","15","false","16352","16.133333333333333","15","15","false","0","16352","29440"
"6.8636035602598024","0.0","0.14569606056357776","1.0","12","8","4","false","17546","9.0","4","4","false","0","17546","0"
"6.052201106567236","0.0","0.16522914265272864","1.0","12","22","11","false","19808","17.0","11","11","false","0","19808","0"
"6.052201106567236","0.0","0.16522914265272864","1.0","12","22","11","false","21931","17.0","11","11","false","0","21931","0"
"6.052201106567236","0.0","0.16522914265272864","1.0","12","22","11","false","22369","18.363636363636363","11","11","false","0","22369","0"
"6.8636035602598024","0.0","0.14569606056357776","1.0","12","8","4","false","22466","9.0","4","4","false","0","22466","0"
"6.8636035602598024","0.0","0.14569606056357776","1.0","12","8","4","false","25159","9.0","4","4","false","0","25159","0"
"6.095020447438056","0.6659669938313955","0.16406835852705529","0.7777777777777778","12","20","10","false","22815","8.8","10","10","false","0","22815","111346349"
"7.218907866249699","0.0","0.1385251091339265","0.0","12","2","1","false","29","4.0","1","1","false","0","29","0"
"7.218907866249699","0.0","0.1385251091339265","0.0","12","2","1","false","16751","4.0","1","1","false","0","16751","0"
"5.732980514794323","0.0","0.17442933870426316","1.0","11","4","2","false","750","8.0","2","2","false","0","750","0"
"5.732980514794323","0.0","0.17442933870426316","1.0","11","4","2","false","19641","8.0","2","2","false","0","19641","0"
"1.0","0.0","1.0","0.0","1","2","1","false","23480","1.0","1","1","false","0","23480","0"
"1.0","0.0","1.0","0.0","1","2","1","false","23652","1.0","1","1","false","0","23652","0"
"5.560500360837143","2.4997431007486166","0.1798399307808782","0.2857142857142857","11","16","8","false","1278","5.625","8","8","false","0","1278","230512671"
"6.559778686552803","0.0","0.1524441673695405","1.0","12","6","3","false","778","4.666666666666667","3","3","false","0","778","0"
"6.559778686552803","0.0","0.1524441673695405","1.0","12","6","3","false","1048","4.666666666666667","3","3","false","0","1048","0"
"5.669232619677652","0.0","0.17639071583145924","1.0","11","6","3","false","16743","9.0","3","3","false","0","16743","0"
"6.559778686552803","0.0","0.1524441673695405","1.0","12","6","3","false","22235","4.666666666666667","3","3","false","0","22235","0"
"5.681019966321867","0.4844496360724753","0.17602472899728996","0.5","12","8","4","false","4376","4.75","4","4","false","0","4376","36161115"
"6.132788068318499","0.0","0.163057974425355","1.0","13","6","3","false","18246","5.0","3","3","false","0","18246","0"
"5.905941784941064","0.0","0.16932100525436844","1.0","12","4","2","false","3718","9.0","2","2","false","0","3718","0"
"5.905941784941064","0.0","0.16932100525436844","1.0","12","4","2","false","7511","9.0","2","2","false","0","7511","0"
"6.0312725523213855","0.0","0.16580248883216336","1.0","12","6","3","false","6642","4.0","3","3","false","0","6642","0"
"6.0312725523213855","0.0","0.16580248883216336","1.0","12","6","3","false","17277","4.0","3","3","false","0","17277","0"
"6.0312725523213855","0.0","0.16580248883216336","1.0","12","6","3","false","18209","4.0","3","3","false","0","18209","0"
"7.3589126774115945","0.0","0.1358896407440097","1.0","13","6","3","false","7247","3.3333333333333335","3","3","false","0","7247","0"
"7.3589126774115945","0.0","0.1358896407440097","1.0","13","6","3","false","9459","3.3333333333333335","3","3","false","0","9459","0"
"7.3589126774115945","0.0","0.1358896407440097","1.0","13","6","3","false","11829","3.3333333333333335","3","3","false","0","11829","0"
"1.0","1.8777777777777778","1.0","0.5333333333333333","1","12","6","false","10338","3.6666666666666665","6","6","false","0","10338","65"
"1.5","0.0","0.6666666666666666","1.0","2","6","3","false","7523","5.333333333333333","3","3","false","0","7523","0"
"1.1666666666666667","0.14444444444444443","0.8571428571428571","0.8","2","10","5","false","12458","4.4","5","5","false","0","12458","13"
"1.3333333333333333","0.0","0.75","1.0","2","8","4","false","12460","5.0","4","4","false","0","12460","0"
"1.8333333333333333","0.0","0.5454545454545455","0.0","2","2","1","false","14844","6.0","1","1","false","0","14844","0"
"1.3333333333333333","0.0","0.75","1.0","2","8","4","false","16651","5.0","4","4","false","0","16651","0"
"1.1666666666666667","0.14444444444444443","0.8571428571428571","0.8","2","10","5","false","19378","4.4","5","5","false","0","19378","13"
"1.0","2.083333333333333","1.0","0.16666666666666666","1","8","4","false","161","1.5","4","4","false","0","161","25"
"1.5","0.0","0.6666666666666666","1.0","2","4","2","false","97","3.0","2","2","false","0","97","0"
"1.75","0.0","0.5714285714285714","0.0","2","2","1","false","3105","4.0","1","1","false","0","3105","0"
"1.75","0.0","0.5714285714285714","0.0","2","2","1","false","11418","4.0","1","1","false","0","11418","0"
"1.5","0.0","0.6666666666666666","1.0","2","4","2","false","19583","3.0","2","2","false","0","19583","0"
"1.75","0.0","0.5714285714285714","0.0","2","2","1","false","21821","4.0","1","1","false","0","21821","0"
"1.0","1.9583333333333333","1.0","0.3333333333333333","1","8","4","false","22719","2.0","4","4","false","0","22719","28"
"1.25","0.375","0.8","0.6666666666666666","2","6","3","false","21684","2.6666666666666665","3","3","false","0","21684","9"
"1.5","0.0","0.6666666666666666","1.0","2","4","2","false","22720","3.5","2","2","false","0","22720","0"
"1.5","0.0","0.6666666666666666","1.0","2","4","2","false","24169","3.5","2","2","false","0","24169","0"
"5.600433004570604","0.7751237346100123","0.17855762209527082","0.3333333333333333","11","6","3","false","16872","7.0","3","3","false","0","16872","61287319"
"1.0","0.0","1.0","1.0","1","4","2","false","24816","2.0","2","2","false","0","24816","0"
"1.0","0.0","1.0","1.0","1","4","2","false","9871","2.0","2","2","false","0","9871","0"
"1.0","0.0","1.0","1.0","1","4","2","false","17179","2.0","2","2","false","0","17179","0"
"7.488573490497955","0.0","0.13353678123996146","1.0","13","6","3","false","19996","3.3333333333333335","3","3","false","0","19996","0"
"7.488573490497955","0.0","0.13353678123996146","1.0","13","6","3","false","380","3.3333333333333335","3","3","false","0","380","0"
"7.488573490497955","0.0","0.13353678123996146","1.0","13","6","3","false","20078","3.3333333333333335","3","3","false","0","20078","0"
"6.429877315371662","0.0","0.15552396273710203","0.0","12","2","1","false","5061","7.0","1","1","false","0","5061","0"
"6.425066153476065","0.0","0.1556404208319293","0.0","12","2","1","false","20317","8.0","1","1","false","0","20317","0"
"7.12966081308636","0.4523662106594242","0.14025912679667993","0.5","14","8","4","false","12411","3.25","4","4","false","0","12411","32724784"
"5.536203993264373","0.0","0.18062918223689928","0.0","11","2","1","false","8922","54.0","1","1","false","0","8922","0"
"5.536203993264373","0.0","0.18062918223689928","0.0","11","2","1","false","9488","54.0","1","1","false","0","9488","0"
"5.536203993264373","0.0","0.18062918223689928","0.0","11","2","1","false","17182","54.0","1","1","false","0","17182","0"
"6.402213134471975","0.0","0.1561959870744721","1.0","12","4","2","false","22894","4.5","2","2","false","0","22894","0"
"5.370700024055809","4.30990272793817E-5","0.18619546716832394","0.9333333333333333","11","12","6","false","10041","44.666666666666664","6","6","false","0","10041","3723"
"5.370940582150589","0.0","0.18618712769292786","1.0","11","10","5","false","13995","44.4","5","5","false","0","13995","0"
"5.183064710127495","0.0","0.1929360438132368","1.0","11","8","4","false","10383","25.75","4","4","false","0","10383","0"
"5.183064710127495","0.0","0.1929360438132368","1.0","11","8","4","false","13319","25.75","4","4","false","0","13319","0"
"5.176569641568439","0.04974737015972213","0.19317812165992843","0.6","11","12","6","false","16115","18.166666666666668","6","6","false","0","16115","12485263"
"5.1363964397401976","0.3021081236833357","0.19468902210565753","0.5","11","8","4","false","21583","25.75","4","4","false","0","21583","37294728"
"7.452008660091412","0.0","0.13419200723093808","0.0","14","2","1","false","25229","3.0","1","1","false","0","25229","0"
"5.538609574212172","0.0","0.18055072967338429","1.0","11","4","2","false","2074","13.5","2","2","false","0","2074","0"
"5.471012749579024","1.3825156656884927","0.18278151519148747","0.3333333333333333","11","8","4","false","10996","8.75","4","4","false","0","10996","95462122"
"5.403897041135434","0.01820216792389801","0.18505163817663817","0.6666666666666666","11","6","3","false","19080","9.0","3","3","false","0","19080","2900551"
"6.560981477026702","0.0","0.1524162205763731","0.0","12","2","1","false","751","3.0","1","1","false","0","751","0"
"6.388501323069521","0.0","0.1565312347027149","0.0","12","2","1","false","2655","8.0","1","1","false","0","2655","0"
"6.388260764974741","0.0","0.1565371290857057","1.0","12","4","2","false","20008","5.0","2","2","false","0","20008","0"
"6.388260764974741","0.0","0.1565371290857057","1.0","12","4","2","false","25866","5.0","2","2","false","0","25866","0"
"6.211450565311523","0.0020134525691586705","0.16099299020177374","0.8666666666666667","13","12","6","false","2087","16.333333333333332","6","6","false","0","2087","313621"
"6.211691123406303","0.0","0.16098675547982338","1.0","13","10","5","false","2993","19.0","5","5","false","0","2993","0"
"6.2343035843156125","0.0","0.16040283994443585","1.0","13","8","4","false","4377","19.75","4","4","false","0","4377","0"
"5.979793120038489","0.6032855194789435","0.16722986563681713","0.6045977011494252","12","60","30","false","6271","19.766666666666666","30","30","false","0","6271","73627380"
"6.19653596343517","0.8909628921397992","0.16138048837299585","0.4","13","20","10","false","7023","11.2","10","10","false","0","7023","91230469"
"5.975703632427231","6.0006407816263385","0.1673443098103941","0.23333333333333334","12","32","16","false","13404","12.375","16","16","false","0","13404","592939564"
"6.071445754149627","1.106191645335819E-6","0.16470541622092794","0.9683794466403162","12","46","23","false","1563","23.347826086956523","23","23","false","0","1563","344"
"6.071445754149627","1.106191645335819E-6","0.16470541622092794","0.9683794466403162","12","46","23","false","2457","23.347826086956523","23","23","false","0","2457","344"
"6.071445754149627","1.106191645335819E-6","0.16470541622092794","0.9683794466403162","12","46","23","false","3534","23.347826086956523","23","23","false","0","3534","344"
"6.072407986528747","0.0","0.16467931703838687","1.0","12","38","19","false","4639","24.05263157894737","19","19","false","0","4639","0"
"6.071445754149627","1.106191645335819E-6","0.16470541622092794","0.9683794466403162","12","46","23","false","5065","23.347826086956523","23","23","false","0","5065","344"
"6.071445754149627","1.106191645335819E-6","0.16470541622092794","0.9683794466403162","12","46","23","false","6387","23.347826086956523","23","23","false","0","6387","344"
"6.071445754149627","1.106191645335819E-6","0.16470541622092794","0.9683794466403162","12","46","23","false","14379","23.347826086956523","23","23","false","0","14379","344"
"6.071926870339187","0.0","0.16469236559565786","1.0","12","42","21","false","15145","23.857142857142858","21","21","false","0","15145","0"
"6.071445754149627","1.106191645335819E-6","0.16470541622092794","0.9683794466403162","12","46","23","false","15562","23.347826086956523","23","23","false","0","15562","344"
"6.071445754149627","1.106191645335819E-6","0.16470541622092794","0.9683794466403162","12","46","23","false","15708","23.347826086956523","23","23","false","0","15708","344"
"6.071445754149627","1.106191645335819E-6","0.16470541622092794","0.9683794466403162","12","46","23","false","15714","23.347826086956523","23","23","false","0","15714","344"
"6.071445754149627","1.106191645335819E-6","0.16470541622092794","0.9683794466403162","12","46","23","false","15805","23.347826086956523","23","23","false","0","15805","344"
"6.117632908347366","0.0","0.16346191655853093","1.0","12","8","4","false","17345","24.25","4","4","false","0","17345","0"
"6.071445754149627","1.106191645335819E-6","0.16470541622092794","0.9683794466403162","12","46","23","false","17580","23.347826086956523","23","23","false","0","17580","344"
"6.071926870339187","0.0","0.16469236559565786","1.0","12","42","21","false","17584","23.857142857142858","21","21","false","0","17584","0"
"6.071205196054847","0.1953803929676111","0.16471194230921626","0.8913043478260869","12","48","24","false","18396","22.416666666666668","24","24","false","0","18396","27190820"
"6.071445754149627","1.106191645335819E-6","0.16470541622092794","0.9683794466403162","12","46","23","false","18952","23.347826086956523","23","23","false","0","18952","344"
"6.071445754149627","1.106191645335819E-6","0.16470541622092794","0.9683794466403162","12","46","23","false","19677","23.347826086956523","23","23","false","0","19677","344"
"6.212172239595862","0.0","0.16097428748451054","1.0","13","6","3","false","20231","19.666666666666668","3","3","false","0","20231","0"
"6.071926870339187","0.0","0.16469236559565786","1.0","12","42","21","false","23241","23.857142857142858","21","21","false","0","23241","0"
"6.071926870339187","0.0","0.16469236559565786","1.0","12","42","21","false","24616","23.857142857142858","21","21","false","0","24616","0"
"6.072407986528747","0.0","0.16467931703838687","1.0","12","38","19","false","24617","24.05263157894737","19","19","false","0","24617","0"
"6.071445754149627","1.106191645335819E-6","0.16470541622092794","0.9683794466403162","12","46","23","false","24819","23.347826086956523","23","23","false","0","24819","344"
"6.778686552802502","0.0","0.14752120373327654","1.0","13","6","3","false","1157","7.333333333333333","3","3","false","0","1157","0"
"6.778686552802502","0.0","0.14752120373327654","1.0","13","6","3","false","16334","7.333333333333333","3","3","false","0","16334","0"
"6.939379360115468","0.0","0.14410510625021666","0.0","12","2","1","false","9922","5.0","1","1","false","0","9922","0"
"6.939138802020688","0.0","0.14411010192054358","1.0","12","4","2","false","2504","3.5","2","2","false","0","2504","0"
"6.939138802020688","0.0","0.14411010192054358","1.0","12","4","2","false","19585","3.5","2","2","false","0","19585","0"
"6.9692085638681744","0.0","0.143488315902109","0.0","13","2","1","false","9987","6.0","1","1","false","0","9987","0"
"6.9692085638681744","0.0","0.143488315902109","0.0","13","2","1","false","21554","6.0","1","1","false","0","21554","0"
"1.0","2.5","1.0","0.0","1","4","2","false","19598","1.0","2","2","false","0","19598","5"
"1.5","0.0","0.6666666666666666","0.0","2","2","1","false","11216","2.0","1","1","false","0","11216","0"
"1.5","0.0","0.6666666666666666","0.0","2","2","1","false","13815","2.0","1","1","false","0","13815","0"
"5.577098869376955","4.533741707327299","0.1793046928916494","0.4666666666666667","11","12","6","false","7463","8.0","6","6","false","0","7463","347441937"
"6.508058696175127","1.4975955766946205","0.15365565165964368","0.3333333333333333","12","6","3","false","12318","4.666666666666667","3","3","false","0","12318","241972482"
"7.507818138080347","0.0","0.13319448894585068","0.0","13","2","1","false","15150","3.0","1","1","false","0","15150","0"
"6.507818138080347","2.064920934180388","0.15366133146046648","0.0","12","6","3","false","19800","3.0","3","3","false","0","19800","166197811"
"6.227567957661775","0.0","0.16057632880098888","0.0","12","2","1","false","7695","10.0","1","1","false","0","7695","0"
"6.089968727447679","0.0","0.16420445568020223","1.0","12","6","3","false","3827","9.666666666666666","3","3","false","0","3827","0"
"6.110897281693529","0.0","0.16364208951698617","1.0","12","6","3","false","8595","8.333333333333334","3","3","false","0","8595","0"
"6.110897281693529","0.0","0.16364208951698617","1.0","12","6","3","false","14691","8.333333333333334","3","3","false","0","14691","0"
"6.483521770507577","0.0","0.15423716236271892","0.0","13","2","1","false","7025","2.0","1","1","false","0","7025","0"
"6.062304546547991","6.328401332863176","0.16495377167572717","0.32142857142857145","12","16","8","false","25540","4.375","8","8","false","0","25540","528232764"
"1.0","0.0","1.0","1.0","1","4","2","false","3239","2.0","2","2","false","0","3239","0"
"1.0","0.0","1.0","1.0","1","4","2","false","11465","2.0","2","2","false","0","11465","0"
"1.0","0.0","1.0","1.0","1","4","2","false","11577","2.0","2","2","false","0","11577","0"
"7.633630021650228","5.907993127308483","0.13099927520247062","0.3","13","10","5","false","6666","2.8","5","5","false","0","6666","804160634"
"7.635554486408467","0.0","0.1309662581519171","0.0","13","2","1","false","17986","4.0","1","1","false","0","17986","0"
"7.635073370218908","0.9595992635541983","0.13097451085415418","0.0","13","4","2","false","21190","2.5","2","2","false","0","21190","131442825"
"5.728650469088285","0.0","0.17456118249769043","1.0","12","4","2","false","9217","14.0","2","2","false","0","9217","0"
"8.63290834736589","0.0","0.11583581798422826","1.0","14","6","3","false","2596","3.6666666666666665","3","3","false","0","2596","0"
"8.63338946355545","0.0","0.11582936275739084","0.0","14","2","1","false","23462","5.0","1","1","false","0","23462","0"
"8.63290834736589","0.0","0.11583581798422826","1.0","14","6","3","false","23464","3.6666666666666665","3","3","false","0","23464","0"
"8.63290834736589","0.0","0.11583581798422826","1.0","14","6","3","false","25644","3.6666666666666665","3","3","false","0","25644","0"
"6.202549915804667","0.0","0.16122401489295687","1.0","12","4","2","false","3452","19.0","2","2","false","0","3452","0"
"5.842193889824393","1.0778383134880223","0.17116857448735898","0.5238095238095238","12","14","7","false","6442","8.857142857142858","7","7","false","0","6442","147870606"
"6.242001443348569","0.0","0.16020502543548637","1.0","12","6","3","false","9968","9.666666666666666","3","3","false","0","9968","0"
"6.241760885253789","0.0","0.16021119975334336","1.0","12","4","2","false","14383","13.5","2","2","false","0","14383","0"
"6.242001443348569","0.0","0.16020502543548637","1.0","12","6","3","false","14652","9.666666666666666","3","3","false","0","14652","0"
"5.603800817897522","3.2712216248104795","0.1784503112255849","0.5238095238095238","12","14","7","false","17681","9.428571428571429","7","7","false","0","17681","333635727"
"5.842434447919173","0.006132910626268424","0.17116152674270185","0.8666666666666667","12","12","6","false","20587","10.833333333333334","6","6","false","0","20587","1308355"
"6.242001443348569","0.0","0.16020502543548637","1.0","12","6","3","false","21592","9.666666666666666","3","3","false","0","21592","0"
"7.47919172480154","0.0","0.13370428741436427","1.0","13","46","23","false","2144","23.08695652173913","23","23","false","0","2144","0"
"7.47919172480154","0.0","0.13370428741436427","1.0","13","46","23","false","2774","23.08695652173913","23","23","false","0","2774","0"
"7.47919172480154","0.0","0.13370428741436427","1.0","13","46","23","false","3055","23.08695652173913","23","23","false","0","3055","0"
"7.47919172480154","0.0","0.13370428741436427","1.0","13","46","23","false","3652","23.08695652173913","23","23","false","0","3652","0"
"7.47919172480154","0.0","0.13370428741436427","1.0","13","46","23","false","3655","23.08695652173913","23","23","false","0","3655","0"
"7.47919172480154","0.0","0.13370428741436427","1.0","13","46","23","false","3766","23.08695652173913","23","23","false","0","3766","0"
"7.47919172480154","0.0","0.13370428741436427","1.0","13","46","23","false","3814","23.08695652173913","23","23","false","0","3814","0"
"7.47919172480154","0.0","0.13370428741436427","1.0","13","46","23","false","6388","23.08695652173913","23","23","false","0","6388","0"
"7.47919172480154","0.0","0.13370428741436427","1.0","13","46","23","false","7096","23.08695652173913","23","23","false","0","7096","0"
"7.47919172480154","0.0","0.13370428741436427","1.0","13","46","23","false","9249","23.08695652173913","23","23","false","0","9249","0"
"7.47919172480154","0.0","0.13370428741436427","1.0","13","46","23","false","12051","23.08695652173913","23","23","false","0","12051","0"
"7.47919172480154","0.0","0.13370428741436427","1.0","13","46","23","false","12423","23.08695652173913","23","23","false","0","12423","0"
"7.47919172480154","0.0","0.13370428741436427","1.0","13","46","23","false","12885","23.08695652173913","23","23","false","0","12885","0"
"7.47919172480154","0.0","0.13370428741436427","1.0","13","46","23","false","14808","23.08695652173913","23","23","false","0","14808","0"
"7.47919172480154","0.0","0.13370428741436427","1.0","13","46","23","false","15173","23.08695652173913","23","23","false","0","15173","0"
"7.47919172480154","0.0","0.13370428741436427","1.0","13","46","23","false","15189","23.08695652173913","23","23","false","0","15189","0"
"7.47919172480154","0.0","0.13370428741436427","1.0","13","46","23","false","15999","23.08695652173913","23","23","false","0","15999","0"
"7.47919172480154","0.0","0.13370428741436427","1.0","13","46","23","false","18942","23.08695652173913","23","23","false","0","18942","0"
"7.47919172480154","0.0","0.13370428741436427","1.0","13","46","23","false","19705","23.08695652173913","23","23","false","0","19705","0"
"7.47919172480154","0.0","0.13370428741436427","1.0","13","46","23","false","20250","23.08695652173913","23","23","false","0","20250","0"
"7.47919172480154","0.0","0.13370428741436427","1.0","13","46","23","false","21030","23.08695652173913","23","23","false","0","21030","0"
"7.47919172480154","0.0","0.13370428741436427","1.0","13","46","23","false","21825","23.08695652173913","23","23","false","0","21825","0"
"7.47919172480154","0.0","0.13370428741436427","1.0","13","46","23","false","25108","23.08695652173913","23","23","false","0","25108","0"
"6.426750060139524","0.0","0.15559964066477017","1.0","11","6","3","false","13684","3.6666666666666665","3","3","false","0","13684","0"
"6.426750060139524","0.0","0.15559964066477017","1.0","11","6","3","false","18283","3.6666666666666665","3","3","false","0","18283","0"
"6.426750060139524","0.0","0.15559964066477017","1.0","11","6","3","false","19301","3.6666666666666665","3","3","false","0","19301","0"
"5.979312003848929","0.0","0.16724332153202445","1.0","12","4","2","false","21814","5.5","2","2","false","0","21814","0"
"5.974981958142892","0.0","0.1673645221032289","1.0","12","8","4","false","1404","6.75","4","4","false","0","1404","0"
"5.974981958142892","0.0","0.1673645221032289","1.0","12","8","4","false","2562","6.75","4","4","false","0","2562","0"
"5.974981958142892","0.0","0.1673645221032289","1.0","12","8","4","false","11199","6.75","4","4","false","0","11199","0"
"5.975463074332452","0.0","0.16735104669887277","1.0","12","4","2","false","18552","9.5","2","2","false","0","18552","0"
"1.0","0.0","1.0","0.0","1","2","1","false","17141","1.0","1","1","false","0","17141","0"
"1.0","0.0","1.0","0.0","1","2","1","false","11462","1.0","1","1","false","0","11462","0"
"5.4645176810199665","0.0","0.18299876738862475","1.0","11","4","2","false","11612","29.0","2","2","false","0","11612","0"
"5.4645176810199665","0.0","0.18299876738862475","1.0","11","4","2","false","24944","29.0","2","2","false","0","24944","0"
"1.0","0.0","1.0","0.0","1","2","1","false","5814","1.0","1","1","false","0","5814","0"
"1.0","0.0","1.0","0.0","1","2","1","false","17690","1.0","1","1","false","0","17690","0"
"1.0","2.583333333333333","1.0","0.16666666666666666","1","8","4","false","1656","1.5","4","4","false","0","1656","31"
"1.75","0.0","0.5714285714285714","0.0","2","2","1","false","4040","4.0","1","1","false","0","4040","0"
"1.5","0.0","0.6666666666666666","1.0","2","4","2","false","5828","3.0","2","2","false","0","5828","0"
"1.75","0.0","0.5714285714285714","0.0","2","2","1","false","11842","4.0","1","1","false","0","11842","0"
"1.5","0.0","0.6666666666666666","1.0","2","4","2","false","21531","3.0","2","2","false","0","21531","0"
"5.613663699783498","0.0","0.17813678436750086","0.0","11","2","1","false","1992","23.0","1","1","false","0","1992","0"
"1.5714285714285714","0.0","0.6363636363636364","1.0","2","6","3","false","3102","4.666666666666667","3","3","false","0","3102","0"
"1.4285714285714286","0.17857142857142855","0.7","0.6666666666666666","2","8","4","false","12414","3.75","4","4","false","0","12414","15"
"1.5714285714285714","0.0","0.6363636363636364","1.0","2","6","3","false","18562","4.666666666666667","3","3","false","0","18562","0"
"1.0","2.821428571428571","1.0","0.2857142857142857","1","14","7","false","24439","2.7142857142857144","7","7","false","0","24439","130"
"1.7142857142857142","0.0","0.5833333333333334","1.0","2","4","2","false","14431","5.5","2","2","false","0","14431","0"
"1.7142857142857142","0.0","0.5833333333333334","1.0","2","4","2","false","20537","5.0","2","2","false","0","20537","0"
"1.5714285714285714","0.09523809523809523","0.6363636363636364","0.6666666666666666","2","6","3","false","20543","3.6666666666666665","3","3","false","0","20543","8"
"1.7142857142857142","0.0","0.5833333333333334","1.0","2","4","2","false","21339","5.0","2","2","false","0","21339","0"
"1.0","2.0","1.0","0.0","1","4","2","false","1092","1.0","2","2","false","0","1092","4"
"1.5","0.0","0.6666666666666666","0.0","2","2","1","false","3196","2.0","1","1","false","0","3196","0"
"1.5","0.0","0.6666666666666666","0.0","2","2","1","false","23226","2.0","1","1","false","0","23226","0"
"7.0923743083954776","0.0","0.14099650646135062","1.0","13","6","3","false","4033","3.6666666666666665","3","3","false","0","4033","0"
"7.0923743083954776","0.0","0.14099650646135062","1.0","13","6","3","false","20782","3.6666666666666665","3","3","false","0","20782","0"
"7.0923743083954776","0.0","0.14099650646135062","1.0","13","6","3","false","23730","3.6666666666666665","3","3","false","0","23730","0"
"6.613904257878278","0.0","0.15119662471812031","0.0","13","2","1","false","4625","10.0","1","1","false","0","4625","0"
"6.395958624007698","0.0","0.15634872874981193","1.0","13","6","3","false","12296","7.666666666666667","3","3","false","0","12296","0"
"6.613904257878278","0.0","0.15119662471812031","0.0","13","2","1","false","20959","10.0","1","1","false","0","20959","0"
"8.036805388501323","0.0","0.12442754946271962","1.0","13","4","2","false","3119","3.5","2","2","false","0","3119","0"
"8.036805388501323","0.0","0.12442754946271962","1.0","13","4","2","false","19004","3.5","2","2","false","0","19004","0"
"6.625691604522492","0.0","0.15092764041680282","0.0","12","2","1","false","7103","7.0","1","1","false","0","7103","0"
"6.520086600914121","1.491159605781081","0.15337219598583235","0.3333333333333333","12","6","3","false","2503","5.0","3","3","false","0","2503","117949977"
"6.52056771710368","0.0","0.15336087951007157","1.0","12","6","3","false","5465","5.666666666666667","3","3","false","0","5465","0"
"6.52056771710368","0.0","0.15336087951007157","1.0","12","6","3","false","18141","5.666666666666667","3","3","false","0","18141","0"
"6.52056771710368","0.0","0.15336087951007157","1.0","12","6","3","false","20663","5.666666666666667","3","3","false","0","20663","0"
"5.360115467885494","0.0","0.18656314513957453","1.0","11","4","2","false","7384","62.5","2","2","false","0","7384","0"
"5.469809959105124","0.0","0.18282170815375143","1.0","11","8","4","false","6944","19.75","4","4","false","0","6944","0"
"5.469809959105124","0.0","0.18282170815375143","1.0","11","8","4","false","12660","19.75","4","4","false","0","12660","0"
"5.469809959105124","0.0","0.18282170815375143","1.0","11","8","4","false","14372","19.75","4","4","false","0","14372","0"
"5.469809959105124","0.0","0.18282170815375143","1.0","11","8","4","false","26178","19.75","4","4","false","0","26178","0"
"5.771710368053885","0.0","0.17325886716959113","1.0","11","6","3","false","7024","11.666666666666666","3","3","false","0","7024","0"
"5.771710368053885","0.0","0.17325886716959113","1.0","11","6","3","false","17393","11.666666666666666","3","3","false","0","17393","0"
"5.772191484243445","0.0","0.1732444259220671","0.0","11","2","1","false","17827","21.0","1","1","false","0","17827","0"
"1.0","0.3095238095238095","1.0","0.8095238095238095","1","14","7","false","24207","5.857142857142857","7","7","false","0","24207","39"
"1.1428571428571428","0.0","0.875","1.0","2","12","6","false","1281","6.5","6","6","false","0","1281","0"
"1.1428571428571428","0.0","0.875","1.0","2","12","6","false","3653","6.5","6","6","false","0","3653","0"
"1.1428571428571428","0.0","0.875","1.0","2","12","6","false","10163","6.5","6","6","false","0","10163","0"
"1.0","0.3095238095238095","1.0","0.8095238095238095","1","14","7","false","12551","5.857142857142857","7","7","false","0","12551","39"
"1.5714285714285714","0.0","0.6363636363636364","1.0","2","6","3","false","17588","7.0","3","3","false","0","17588","0"
"1.0","0.3095238095238095","1.0","0.8095238095238095","1","14","7","false","18621","5.857142857142857","7","7","false","0","18621","39"
"1.1428571428571428","0.0","0.875","1.0","2","12","6","false","25287","6.5","6","6","false","0","25287","0"
"1.0","1.1666666666666665","1.0","0.3333333333333333","1","6","3","false","9962","1.6666666666666667","3","3","false","0","9962","7"
"1.3333333333333333","0.0","0.75","1.0","2","4","2","false","2506","2.5","2","2","false","0","2506","0"
"1.3333333333333333","0.0","0.75","1.0","2","4","2","false","10682","2.5","2","2","false","0","10682","0"
"1.6666666666666667","0.0","0.6","0.0","2","2","1","false","22428","3.0","1","1","false","0","22428","0"
"1.0","0.0","1.0","0.0","1","2","1","false","6354","1.0","1","1","false","0","6354","0"
"1.0","0.0","1.0","0.0","1","2","1","false","15188","1.0","1","1","false","0","15188","0"
"6.249939860476305","0.0","0.160001539586621","0.0","12","2","1","false","19060","3.0","1","1","false","0","19060","0"
"5.7120519605484725","2.942437448395626","0.17506843546009687","0.4","12","10","5","false","10004","7.0","5","5","false","0","10004","188717321"
"5.975703632427231","0.0","0.1673443098103941","1.0","12","6","3","false","25234","5.333333333333333","3","3","false","0","25234","0"
"6.265095020447438","4.6992834905622365","0.15961449854093074","0.2222222222222222","11","20","10","false","18314","3.888888888888889","10","9","false","1","18314","439136666"
"7.264613904257878","0.0","0.13765356468757245","1.0","12","4","2","false","3684","6.5","2","2","false","0","3684","0"
"6.752706278566274","0.0","0.14808877489223754","1.0","12","6","3","false","5395","8.0","3","3","false","0","5395","0"
"7.264613904257878","0.0","0.13765356468757245","1.0","12","4","2","false","5445","7.0","2","2","false","0","5445","0"
"6.752225162376714","0.4640640845498082","0.14809932665930386","0.5","12","10","5","false","11141","5.2","5","5","false","0","11141","55724540"
"6.408227086841472","1.013753009732128","0.15604940125380082","0.5","11","8","4","false","18370","4.5","4","4","false","0","18370","132154236"
"7.264613904257878","0.0","0.13765356468757245","1.0","12","4","2","false","19447","7.0","2","2","false","0","19447","0"
"7.264613904257878","0.0","0.13765356468757245","1.0","12","4","2","false","20434","6.5","2","2","false","0","20434","0"
"6.8628818859754634","0.0","0.14571138140138104","1.0","13","6","3","false","4263","5.333333333333333","3","3","false","0","4263","0"
"6.8628818859754634","0.0","0.14571138140138104","1.0","13","6","3","false","6859","5.333333333333333","3","3","false","0","6859","0"
"6.36829444310801","0.019721062700310772","0.15702791523438975","0.6666666666666666","12","6","3","false","17999","7.666666666666667","3","3","false","0","17999","2247198"
"6.8628818859754634","0.0","0.14571138140138104","1.0","13","6","3","false","18282","5.333333333333333","3","3","false","0","18282","0"
"1.0","0.0","1.0","1.0","1","4","2","false","9959","2.0","2","2","false","0","9959","0"
"1.0","0.0","1.0","1.0","1","4","2","false","6008","2.0","2","2","false","0","6008","0"
"1.0","0.0","1.0","1.0","1","4","2","false","20914","2.0","2","2","false","0","20914","0"
"1.5","0.0","0.6666666666666666","0.0","2","2","1","false","5081","2.0","1","1","false","0","5081","0"
"1.0","2.5","1.0","0.0","1","4","2","false","12256","1.0","2","2","false","0","12256","5"
"1.5","0.0","0.6666666666666666","0.0","2","2","1","false","17237","2.0","1","1","false","0","17237","0"
"6.692326196776522","0.0","0.14942487419122932","0.0","13","2","1","false","8877","5.0","1","1","false","0","8877","0"
"5.39090690401732","0.0","0.1854975457385096","1.0","11","4","2","false","3280","34.0","2","2","false","0","3280","0"
"6.111618955977868","0.0","0.16362276627568292","0.0","11","2","1","false","13191","13.0","1","1","false","0","13191","0"
"5.855184026942506","0.0","0.1707888249794577","0.0","11","2","1","false","13013","17.0","1","1","false","0","13013","0"
"5.5003608371421695","2.92630874608839","0.18180625410015308","0.2","11","10","5","false","18899","7.0","5","5","false","0","18899","405840916"
"6.269665624248256","0.6806650331560365","0.15949813912442928","0.0","12","4","2","false","21293","5.0","2","2","false","0","21293","36377758"
"1.0","0.0","1.0","0.0","1","2","1","false","1107","1.0","1","1","false","0","1107","0"
"1.0","0.0","1.0","0.0","1","2","1","false","6973","1.0","1","1","false","0","6973","0"
"7.236709165263411","0.0","0.13818435661336967","0.0","12","2","1","false","2950","2.0","1","1","false","0","2950","0"
"6.5171999037767625","0.0","0.1534401299276539","0.0","12","2","1","false","9335","3.0","1","1","false","0","9335","0"
"6.5171999037767625","0.0","0.1534401299276539","0.0","12","2","1","false","25235","3.0","1","1","false","0","25235","0"
"6.52056771710368","0.0","0.15336087951007157","0.0","12","2","1","false","25668","4.0","1","1","false","0","25668","0"
"7.470772191484244","0.0","0.13385497166409066","0.0","14","2","1","false","6455","2.0","1","1","false","0","6455","0"
"6.431561222035121","0.0","0.15548324356672652","0.0","12","2","1","false","19801","4.0","1","1","false","0","19801","0"
"5.6497474140004815","1.7047332395543053","0.17699906327173634","0.3333333333333333","12","14","7","false","65","5.571428571428571","7","7","false","0","65","143181446"
"5.938898243925908","0.0","0.16838139987038236","1.0","12","4","2","false","358","8.0","2","2","false","0","358","0"
"7.382968486889584","0.0","0.13544687367632205","0.0","14","2","1","false","8504","10.0","1","1","false","0","8504","0"
"6.823430358431561","0.0","0.14655385157764853","1.0","13","4","2","false","21152","13.0","2","2","false","0","21152","0"
"6.557854221794563","0.0","0.15248890356186495","0.0","13","2","1","false","19379","6.0","1","1","false","0","19379","0"
"9.627856627375511","0.0","0.10386527746545736","0.0","15","2","1","false","19247","3.0","1","1","false","0","19247","0"
"7.062063988453211","0.0","0.14160166229519366","0.0","13","2","1","false","18586","8.0","1","1","false","0","18586","0"
"7.061342314168872","0.0","0.14161613408734755","1.0","13","8","4","false","27","5.0","4","4","false","0","27","0"
"7.061342314168872","0.0","0.14161613408734755","1.0","13","8","4","false","11114","5.0","4","4","false","0","11114","0"
"7.061342314168872","0.0","0.14161613408734755","1.0","13","8","4","false","19081","5.0","4","4","false","0","19081","0"
"7.061342314168872","0.0","0.14161613408734755","1.0","13","8","4","false","24726","5.0","4","4","false","0","24726","0"
"1.0","0.0","1.0","1.0","1","4","2","false","12320","2.0","2","2","false","0","12320","0"
"1.0","0.0","1.0","1.0","1","4","2","false","12321","2.0","2","2","false","0","12321","0"
"1.0","0.0","1.0","1.0","1","4","2","false","19222","2.0","2","2","false","0","19222","0"
"6.706278566273755","0.0","0.14911399669990674","0.0","12","2","1","false","18344","3.0","1","1","false","0","18344","0"
"6.149867693047871","0.0","0.16260512419323295","0.0","11","2","1","false","3292","7.0","1","1","false","0","3292","0"
"6.120279047389944","0.0","0.1633912428268218","1.0","11","4","2","false","10391","5.5","2","2","false","0","10391","0"
"7.740437815732499","0.0","0.12919165863815768","1.0","13","4","2","false","1857","3.0","2","2","false","0","1857","0"
"7.740437815732499","0.0","0.12919165863815768","1.0","13","4","2","false","3967","3.0","2","2","false","0","3967","0"
"6.740918931922059","2.5210282851402934","0.14834772678609665","0.3333333333333333","12","8","4","false","12053","2.75","4","4","false","0","12053","220577162"
"6.741159490016839","3.682171125943855E-4","0.14834243300146308","0.6666666666666666","12","6","3","false","880","3.6666666666666665","3","3","false","0","880","12723"
"6.523213856146259","0.0","0.15329866873179188","0.0","12","2","1","false","252","5.0","1","1","false","0","252","0"
"6.523213856146259","0.0","0.15329866873179188","0.0","12","2","1","false","15418","5.0","1","1","false","0","15418","0"
"1.0","0.0","1.0","1.0","1","4","2","false","4019","2.0","2","2","false","0","4019","0"
"1.0","0.0","1.0","1.0","1","4","2","false","5626","2.0","2","2","false","0","5626","0"
"1.0","0.0","1.0","1.0","1","4","2","false","24957","2.0","2","2","false","0","24957","0"
"6.554486408467645","0.0","0.1525672551106544","1.0","13","4","2","false","4148","4.5","2","2","false","0","4148","0"
"6.554486408467645","0.0","0.1525672551106544","1.0","13","4","2","false","9863","4.5","2","2","false","0","9863","0"
"6.1452970892470535","0.0","0.1627260627886949","1.0","12","4","2","false","8457","7.5","2","2","false","0","8457","0"
"6.89054606687515","0.0","0.14512637899734673","0.0","12","2","1","false","15478","9.0","1","1","false","0","15478","0"
"6.6321866730815495","0.0","0.15077983315197677","1.0","12","4","2","false","24203","6.0","2","2","false","0","24203","0"
"1.0","2.0","1.0","0.0","1","6","3","false","8557","1.0","3","3","false","0","8557","12"
"1.6666666666666667","0.0","0.6","0.0","2","2","1","false","8308","3.0","1","1","false","0","8308","0"
"1.6666666666666667","0.0","0.6","0.0","2","2","1","false","21288","3.0","1","1","false","0","21288","0"
"1.6666666666666667","0.0","0.6","0.0","2","2","1","false","26191","3.0","1","1","false","0","26191","0"
"8.728650469088285","3.7524610899018156","0.11456524734738872","0.2","15","10","5","false","3516","2.6","5","5","false","0","3516","974921537"
"9.728409910993506","0.0","0.10279172127296554","0.0","16","2","1","false","7053","5.0","1","1","false","0","7053","0"
"9.728169352898725","0.0","0.10279426310583581","1.0","16","4","2","false","12618","3.5","2","2","false","0","12618","0"
"7.731056050036083","2.4991978116853812","0.1293484348746033","0.6666666666666666","14","6","3","false","13144","4.666666666666667","3","3","false","0","13144","650030893"
"7.7305749338465235","4.149318102309196","0.12935648493900923","0.3","14","10","5","false","15413","3.2","5","5","false","0","15413","865127401"
"9.728169352898725","0.0","0.10279426310583581","1.0","16","4","2","false","18634","3.5","2","2","false","0","18634","0"
"1.75","0.0","0.5714285714285714","0.0","2","2","1","false","1378","4.0","1","1","false","0","1378","0"
"1.0","2.75","1.0","0.16666666666666666","1","8","4","false","7877","1.5","4","4","false","0","7877","33"
"1.5","0.0","0.6666666666666666","1.0","2","4","2","false","3852","3.0","2","2","false","0","3852","0"
"1.5","0.0","0.6666666666666666","1.0","2","4","2","false","11622","3.0","2","2","false","0","11622","0"
"1.75","0.0","0.5714285714285714","0.0","2","2","1","false","15422","4.0","1","1","false","0","15422","0"
"1.5","0.0","0.6666666666666666","1.0","2","4","2","false","2984","3.0","2","2","false","0","2984","0"
"1.5","0.0","0.6666666666666666","1.0","2","4","2","false","8731","3.0","2","2","false","0","8731","0"
"1.0","2.0","1.0","0.3333333333333333","1","8","4","false","10564","2.0","4","4","false","0","10564","24"
"1.5","0.0","0.6666666666666666","1.0","2","4","2","false","8970","3.0","2","2","false","0","8970","0"
"1.5","0.0","0.6666666666666666","1.0","2","4","2","false","15187","3.0","2","2","false","0","15187","0"
"6.538369016117392","0.0","0.15294334069168505","0.0","12","2","1","false","3850","5.0","1","1","false","0","3850","0"
"5.910512388741881","0.0","0.16919006919006918","1.0","11","4","2","false","9128","9.0","2","2","false","0","9128","0"
"5.618955977868655","0.6611963238833439","0.1779690041955647","0.5","11","8","4","false","113","8.0","4","4","false","0","113","55015920"
"5.967284099109935","0.0","0.16758042409094576","1.0","11","6","3","false","4103","8.0","3","3","false","0","4103","0"
"5.967284099109935","0.0","0.16758042409094576","1.0","11","6","3","false","12312","8.0","3","3","false","0","12312","0"
"6.0040894876112585","0.0","0.1665531471613446","1.0","11","4","2","false","17994","7.5","2","2","false","0","17994","0"
"5.881885975463074","0.4494416928357753","0.17001349638051613","0.6666666666666666","11","6","3","false","20947","10.333333333333334","3","3","false","0","20947","56035534"
"6.0040894876112585","0.0","0.1665531471613446","1.0","11","4","2","false","26021","7.5","2","2","false","0","26021","0"
"5.770026461390426","0.17196257796820907","0.17330943050112566","0.8","12","12","6","false","3204","8.333333333333334","6","6","false","0","3204","31941564"
"5.770026461390426","0.17196257796820907","0.17330943050112566","0.8","12","12","6","false","25937","8.333333333333334","6","6","false","0","25937","31941564"
"1.0","0.0","1.0","0.0","1","2","1","false","2476","1.0","1","1","false","0","2476","0"
"1.0","0.0","1.0","0.0","1","2","1","false","18984","1.0","1","1","false","0","18984","0"
"1.0","0.0","1.0","1.0","1","4","2","false","187","2.0","2","2","false","0","187","0"
"1.0","0.0","1.0","1.0","1","4","2","false","1821","2.0","2","2","false","0","1821","0"
"1.0","0.0","1.0","1.0","1","4","2","false","21386","2.0","2","2","false","0","21386","0"
"6.125571325475102","0.0","0.16325007854225573","1.0","11","4","2","false","866","5.5","2","2","false","0","866","0"
"5.721433726244888","0.0","0.17478136562394886","1.0","11","6","3","false","17825","7.0","3","3","false","0","17825","0"
"6.125571325475102","0.0","0.16325007854225573","1.0","11","4","2","false","20173","5.5","2","2","false","0","20173","0"
"6.942025499158047","0.0","0.14405017672742393","1.0","13","10","5","false","6305","6.8","5","5","false","0","6305","0"
"6.942025499158047","0.0","0.14405017672742393","1.0","13","10","5","false","7726","6.8","5","5","false","0","7726","0"
"6.942025499158047","0.0","0.14405017672742393","1.0","13","10","5","false","14870","6.8","5","5","false","0","14870","0"
"6.867211931681501","2.306354103943908","0.1456195046764984","0.4444444444444444","12","20","10","false","14872","6.6","10","10","false","0","14872","204745606"
"6.942025499158047","0.0","0.14405017672742393","1.0","13","10","5","false","20316","6.8","5","5","false","0","20316","0"
"6.859514072648545","1.2934252688831906","0.14578292126950726","0.5636363636363636","12","22","11","false","1493","7.363636363636363","11","11","false","0","1493","202076449"
"7.542699061823431","0.0","0.13257853611864137","1.0","13","10","5","false","2452","8.4","5","5","false","0","2452","0"
"6.859514072648545","1.2934252688831906","0.14578292126950726","0.5636363636363636","12","22","11","false","3811","7.363636363636363","11","11","false","0","3811","202076449"
"7.542699061823431","0.0","0.13257853611864137","1.0","13","10","5","false","9027","8.4","5","5","false","0","9027","0"
"7.542699061823431","0.0","0.13257853611864137","1.0","13","10","5","false","14153","8.4","5","5","false","0","14153","0"
"5.971854702910753","0.024195580423364883","0.16745216515609265","0.6666666666666666","11","6","3","false","1436","8.333333333333334","3","3","false","0","1436","4071952"
"6.051719990377676","0.0","0.16524227849107603","1.0","11","4","2","false","20064","7.5","2","2","false","0","20064","0"
"6.051960548472456","0.0","0.16523571031083553","0.0","11","2","1","false","20331","12.0","1","1","false","0","20331","0"
"5.765215299494828","0.0","0.1734540599182175","0.0","11","2","1","false","13864","18.0","1","1","false","0","13864","0"
"6.207120519605485","0.0","0.16110529783358524","1.0","12","4","2","false","21154","7.0","2","2","false","0","21154","0"
"1.0","0.0","1.0","0.0","1","2","1","false","10133","1.0","1","1","false","0","10133","0"
"1.0","0.0","1.0","0.0","1","2","1","false","18218","1.0","1","1","false","0","18218","0"
"1.0","0.0","1.0","0.0","1","2","1","false","3067","1.0","1","1","false","0","3067","0"
"1.0","0.0","1.0","0.0","1","2","1","false","18721","1.0","1","1","false","0","18721","0"
"6.822227567957662","0.0","0.14657968970380816","1.0","12","68","34","false","1293","34.23529411764706","34","34","false","0","1293","0"
"6.822227567957662","0.0","0.14657968970380816","1.0","12","68","34","false","2621","34.23529411764706","34","34","false","0","2621","0"
"6.822227567957662","0.0","0.14657968970380816","1.0","12","68","34","false","2623","34.23529411764706","34","34","false","0","2623","0"
"6.822227567957662","0.0","0.14657968970380816","1.0","12","68","34","false","3283","34.23529411764706","34","34","false","0","3283","0"
"6.822227567957662","0.0","0.14657968970380816","1.0","12","68","34","false","3812","34.23529411764706","34","34","false","0","3812","0"
"6.822227567957662","0.0","0.14657968970380816","1.0","12","68","34","false","3820","34.23529411764706","34","34","false","0","3820","0"
"6.822227567957662","0.0","0.14657968970380816","1.0","12","68","34","false","3824","34.23529411764706","34","34","false","0","3824","0"
"6.821746451768102","1.9299464266241086","0.14659002750546582","0.8920634920634921","12","72","36","false","4834","32.388888888888886","36","36","false","0","4834","200443812"
"6.822227567957662","0.0","0.14657968970380816","1.0","12","68","34","false","5131","34.23529411764706","34","34","false","0","5131","0"
"6.822227567957662","0.0","0.14657968970380816","1.0","12","68","34","false","6222","34.23529411764706","34","34","false","0","6222","0"
"6.822227567957662","0.0","0.14657968970380816","1.0","12","68","34","false","6456","34.23529411764706","34","34","false","0","6456","0"
"6.822227567957662","0.0","0.14657968970380816","1.0","12","68","34","false","6525","34.23529411764706","34","34","false","0","6525","0"
"6.822227567957662","0.0","0.14657968970380816","1.0","12","68","34","false","6868","34.23529411764706","34","34","false","0","6868","0"
"6.822227567957662","0.0","0.14657968970380816","1.0","12","68","34","false","7525","34.23529411764706","34","34","false","0","7525","0"
"6.822227567957662","0.0","0.14657968970380816","1.0","12","68","34","false","8448","34.23529411764706","34","34","false","0","8448","0"
"6.822227567957662","0.0","0.14657968970380816","1.0","12","68","34","false","9433","34.23529411764706","34","34","false","0","9433","0"
"6.822227567957662","0.0","0.14657968970380816","1.0","12","68","34","false","12802","34.23529411764706","34","34","false","0","12802","0"
"6.822227567957662","0.0","0.14657968970380816","1.0","12","68","34","false","13482","34.23529411764706","34","34","false","0","13482","0"
"6.822227567957662","0.0","0.14657968970380816","1.0","12","68","34","false","13526","34.23529411764706","34","34","false","0","13526","0"
"6.821505893673322","1.8317841955415486","0.14659519695313328","0.8468468468468469","12","74","37","false","14157","31.62162162162162","37","37","false","0","14157","190170519"
"6.822227567957662","0.0","0.14657968970380816","1.0","12","68","34","false","14373","34.23529411764706","34","34","false","0","14373","0"
"6.822227567957662","0.0","0.14657968970380816","1.0","12","68","34","false","15148","34.23529411764706","34","34","false","0","15148","0"
"6.822227567957662","0.0","0.14657968970380816","1.0","12","68","34","false","17600","34.23529411764706","34","34","false","0","17600","0"
"6.822227567957662","0.0","0.14657968970380816","1.0","12","68","34","false","17819","34.23529411764706","34","34","false","0","17819","0"
"6.822227567957662","0.0","0.14657968970380816","1.0","12","68","34","false","17823","34.23529411764706","34","34","false","0","17823","0"
"6.822227567957662","0.0","0.14657968970380816","1.0","12","68","34","false","17824","34.23529411764706","34","34","false","0","17824","0"
"6.822227567957662","0.0","0.14657968970380816","1.0","12","68","34","false","18000","34.23529411764706","34","34","false","0","18000","0"
"6.822227567957662","0.0","0.14657968970380816","1.0","12","68","34","false","18444","34.23529411764706","34","34","false","0","18444","0"
"6.822227567957662","0.0","0.14657968970380816","1.0","12","68","34","false","22324","34.23529411764706","34","34","false","0","22324","0"
"6.822227567957662","0.0","0.14657968970380816","1.0","12","68","34","false","22901","34.23529411764706","34","34","false","0","22901","0"
"6.822227567957662","0.0","0.14657968970380816","1.0","12","68","34","false","24474","34.23529411764706","34","34","false","0","24474","0"
"6.822227567957662","0.0","0.14657968970380816","1.0","12","68","34","false","24479","34.23529411764706","34","34","false","0","24479","0"
"6.822227567957662","0.0","0.14657968970380816","1.0","12","68","34","false","24615","34.23529411764706","34","34","false","0","24615","0"
"6.822227567957662","0.0","0.14657968970380816","1.0","12","68","34","false","26039","34.23529411764706","34","34","false","0","26039","0"
"1.0","0.0","1.0","1.0","1","4","2","false","844","2.0","2","2","false","0","844","0"
"1.0","0.0","1.0","1.0","1","4","2","false","890","2.0","2","2","false","0","890","0"
"1.0","0.0","1.0","1.0","1","4","2","false","11197","2.0","2","2","false","0","11197","0"
"8.246812605244166","0.0","0.12125896972171986","1.0","13","6","3","false","13035","3.6666666666666665","3","3","false","0","13035","0"
"8.246812605244166","0.0","0.12125896972171986","1.0","13","6","3","false","16110","3.6666666666666665","3","3","false","0","16110","0"
"8.246812605244166","0.0","0.12125896972171986","1.0","13","6","3","false","26130","3.6666666666666665","3","3","false","0","26130","0"
"1.0","0.0","1.0","1.0","1","4","2","false","1916","2.0","2","2","false","0","1916","0"
"1.0","0.0","1.0","1.0","1","4","2","false","20953","2.0","2","2","false","0","20953","0"
"1.0","0.0","1.0","1.0","1","4","2","false","24463","2.0","2","2","false","0","24463","0"
"1.0","1.5","1.0","0.0","1","4","2","false","15706","1.0","2","2","false","0","15706","3"
"1.5","0.0","0.6666666666666666","0.0","2","2","1","false","374","2.0","1","1","false","0","374","0"
"1.5","0.0","0.6666666666666666","0.0","2","2","1","false","20776","2.0","1","1","false","0","20776","0"
"6.603079143613183","0.0","0.1514444970672884","1.0","13","4","2","false","25449","7.0","2","2","false","0","25449","0"
"7.403415924945874","0.0","0.13507278398752273","0.0","13","2","1","false","24341","7.0","1","1","false","0","24341","0"
"6.318017801299014","0.0","0.1582774901005178","0.0","12","2","1","false","23135","4.0","1","1","false","0","23135","0"
"6.819821987009863","0.0","0.14663139329805996","1.0","13","6","3","false","17818","5.333333333333333","3","3","false","0","17818","0"
"6.468607168631224","1.9132763336244887","0.15459278542209","0.26666666666666666","12","12","6","false","19697","3.5","6","6","false","0","19697","174791567"
"6.925667548713014","0.0","0.14439041333796457","1.0","13","4","2","false","23219","5.0","2","2","false","0","23219","0"
"6.819581428915083","0.03288685859123173","0.14663656566369182","0.6666666666666666","13","8","4","false","23809","4.25","4","4","false","0","23809","3905961"
"8.405580947798894","0.0","0.118968576498197","0.0","14","2","1","false","11583","4.0","1","1","false","0","11583","0"
"1.0","0.0","1.0","0.0","1","2","1","false","19252","1.0","1","1","false","0","19252","0"
"1.0","0.0","1.0","0.0","1","2","1","false","3195","1.0","1","1","false","0","3195","0"
"1.75","0.0","0.5714285714285714","0.0","2","2","1","false","24597","4.0","1","1","false","0","24597","0"
"1.0","1.5833333333333333","1.0","0.5","1","8","4","false","17280","2.5","4","4","false","0","17280","19"
"1.25","0.0","0.8","1.0","2","6","3","false","2785","3.3333333333333335","3","3","false","0","2785","0"
"1.25","0.0","0.8","1.0","2","6","3","false","3682","3.3333333333333335","3","3","false","0","3682","0"
"1.25","0.0","0.8","1.0","2","6","3","false","19956","3.3333333333333335","3","3","false","0","19956","0"
"10.39162857830166","0.0","0.09623130700495393","0.0","16","2","1","false","2879","3.0","1","1","false","0","2879","0"
"1.0","2.5","1.0","0.0","1","4","2","false","7861","1.0","2","2","false","0","7861","5"
"1.5","0.0","0.6666666666666666","0.0","2","2","1","false","2355","2.0","1","1","false","0","2355","0"
"1.5","0.0","0.6666666666666666","0.0","2","2","1","false","12704","2.0","1","1","false","0","12704","0"
"7.363964397401973","1.1660253713543236","0.13579641970469097","0.3333333333333333","12","6","3","false","17297","2.6666666666666665","3","3","false","0","17297","85793371"
"7.364204955496753","0.0","0.135791983797733","1.0","12","4","2","false","16227","4.0","2","2","false","0","16227","0"
"8.363723839307193","0.0","0.11956396686608375","0.0","13","2","1","false","25219","3.0","1","1","false","0","25219","0"
"8.246572047149387","1.4864594617935167","0.12126250692803593","0.3333333333333333","13","6","3","false","25089","2.0","3","3","false","0","25089","104073944"
"7.044984363723839","1.1616976409331246","0.14194495663456944","0.0","13","4","2","false","820","1.5","2","2","false","0","820","92627564"
"8.044743805629059","0.0","0.12430476646133605","0.0","14","2","1","false","2515","2.0","1","1","false","0","2515","0"
"1.0","0.0","1.0","0.0","1","2","1","false","194","1.0","1","1","false","0","194","0"
"1.0","0.0","1.0","0.0","1","2","1","false","8628","1.0","1","1","false","0","8628","0"
"6.297570363242723","2.675524869284806","0.1587913976851675","0.2","12","10","5","false","4425","4.4","5","5","false","0","4425","213648311"
"6.398845321145057","0.0","0.1562781954887218","0.0","12","2","1","false","7278","12.0","1","1","false","0","7278","0"
"6.24007697859033","0.0","0.160254433307633","1.0","12","4","2","false","14559","12.0","2","2","false","0","14559","0"
"5.664421457782054","0.0","0.17654053594937785","0.0","11","2","1","false","2459","11.0","1","1","false","0","2459","0"
"5.664421457782054","0.0","0.17654053594937785","0.0","11","2","1","false","6380","11.0","1","1","false","0","6380","0"
"6.578542217945634","0.0","0.152009361173072","0.0","12","2","1","false","1025","11.0","1","1","false","0","1025","0"
"6.578301659850854","0.0","0.15201491991516128","1.0","12","4","2","false","1026","6.5","2","2","false","0","1026","0"
"6.578301659850854","0.0","0.15201491991516128","1.0","12","4","2","false","1696","6.5","2","2","false","0","1696","0"
"6.578301659850854","0.0","0.15201491991516128","1.0","12","4","2","false","15197","6.5","2","2","false","0","15197","0"
"6.578301659850854","0.0","0.15201491991516128","1.0","12","4","2","false","18195","6.5","2","2","false","0","18195","0"
"6.93480875631465","0.0","0.1442000832523935","0.0","12","2","1","false","13832","3.0","1","1","false","0","13832","0"
"8.340870820303103","0.0","0.11989155827300782","1.0","13","4","2","false","17114","3.0","2","2","false","0","17114","0"
"8.340870820303103","0.0","0.11989155827300782","1.0","13","4","2","false","20489","3.0","2","2","false","0","20489","0"
"8.339908587923984","0.0","0.11990539098329919","1.0","13","4","2","false","7088","4.0","2","2","false","0","7088","0"
"8.339427471734425","2.6068035108053182","0.11991230853549484","0.16666666666666666","13","8","4","false","7546","2.0","4","4","false","0","7546","178144642"
"1.0","0.0","1.0","0.0","1","2","1","false","8146","1.0","1","1","false","0","8146","0"
"1.0","0.0","1.0","0.0","1","2","1","false","21028","1.0","1","1","false","0","21028","0"
"7.405821505893673","0.0","0.13502890924446176","0.0","13","2","1","false","23418","3.0","1","1","false","0","23418","0"
"1.0","0.0","1.0","0.0","1","2","1","false","10897","1.0","1","1","false","0","10897","0"
"1.0","0.0","1.0","0.0","1","2","1","false","5548","1.0","1","1","false","0","5548","0"
"6.144334856867934","0.6523223580342583","0.1627515464724767","0.3333333333333333","12","6","3","false","15898","4.0","3","3","false","0","15898","53971584"
"6.737310560500361","0.0","0.14842717891955584","0.0","12","2","1","false","11924","12.0","1","1","false","0","11924","0"
"6.737310560500361","0.0","0.14842717891955584","0.0","12","2","1","false","25437","12.0","1","1","false","0","25437","0"
"1.0","0.0","1.0","1.0","1","4","2","false","6159","2.0","2","2","false","0","6159","0"
"1.0","0.0","1.0","1.0","1","4","2","false","19554","2.0","2","2","false","0","19554","0"
"1.0","0.0","1.0","1.0","1","4","2","false","24878","2.0","2","2","false","0","24878","0"
"1.0","0.0","1.0","0.0","1","2","1","false","5577","1.0","1","1","false","0","5577","0"
"1.0","0.0","1.0","0.0","1","2","1","false","23881","1.0","1","1","false","0","23881","0"
"1.6","0.0","0.625","1.0","2","4","2","false","12387","4.0","2","2","false","0","12387","0"
"1.4","0.07500000000000001","0.7142857142857143","0.6666666666666666","2","6","3","false","19520","3.0","3","3","false","0","19520","3"
"1.0","2.375","1.0","0.2","1","10","5","false","23084","1.8","5","5","false","0","23084","49"
"1.6","0.0","0.625","1.0","2","4","2","false","23554","4.0","2","2","false","0","23554","0"
"1.8","0.0","0.5555555555555556","0.0","2","2","1","false","19931","5.0","1","1","false","0","19931","0"
"1.8","0.0","0.5555555555555556","0.0","2","2","1","false","23553","5.0","1","1","false","0","23553","0"
"8.025018041857109","0.0","0.12461031175059951","0.0","14","2","1","false","22888","2.0","1","1","false","0","22888","0"
"6.460909309598268","0.0","0.15477697520291905","0.0","13","2","1","false","12547","13.0","1","1","false","0","12547","0"
"6.460909309598268","0.0","0.15477697520291905","0.0","13","2","1","false","25181","13.0","1","1","false","0","25181","0"
"1.5","0.0","0.6666666666666666","0.0","2","2","1","false","12617","2.0","1","1","false","0","12617","0"
"1.0","2.5","1.0","0.0","1","4","2","false","17388","1.0","2","2","false","0","17388","5"
"1.5","0.0","0.6666666666666666","0.0","2","2","1","false","6037","2.0","1","1","false","0","6037","0"
"6.430839547750781","0.0","0.1555006920285789","0.0","11","2","1","false","3431","5.0","1","1","false","0","3431","0"
"6.766658648063507","0.0","0.1477834263571403","1.0","12","4","2","false","164","8.0","2","2","false","0","164","0"
"6.607649747414","1.040977589663457","0.15133974078928208","0.6","12","10","5","false","2142","4.2","5","5","false","0","2142","85024713"
"6.60789030550878","0.0","0.15133423131530088","1.0","12","8","4","false","13283","5.25","4","4","false","0","13283","0"
"6.60789030550878","0.0","0.15133423131530088","1.0","12","8","4","false","23858","5.25","4","4","false","0","23858","0"
"6.60789030550878","0.0","0.15133423131530088","1.0","12","8","4","false","24601","5.25","4","4","false","0","24601","0"
"1.0","0.0","1.0","1.0","1","4","2","false","800","2.0","2","2","false","0","800","0"
"1.0","0.0","1.0","1.0","1","4","2","false","13167","2.0","2","2","false","0","13167","0"
"1.0","0.0","1.0","1.0","1","4","2","false","15485","2.0","2","2","false","0","15485","0"
"7.468366610536444","0.0","0.13389808671004316","0.0","13","2","1","false","20260","6.0","1","1","false","0","20260","0"
"6.559297570363243","3.328486593227375","0.15245534895661422","0.4","12","10","5","false","4275","3.0","5","5","false","0","4275","207980665"
"7.558575896078903","0.0","0.13230005410394322","1.0","13","6","3","false","4081","3.6666666666666665","3","3","false","0","4081","0"
"7.558575896078903","0.0","0.13230005410394322","1.0","13","6","3","false","13625","3.6666666666666665","3","3","false","0","13625","0"
"6.560019244647583","0.0","0.15243857719105244","1.0","12","4","2","false","17878","4.5","2","2","false","0","17878","0"
"7.558575896078903","0.0","0.13230005410394322","1.0","13","6","3","false","24471","3.6666666666666665","3","3","false","0","24471","0"
"6.185951407264854","5.734791459743779","0.1616566206494264","0.2692307692307692","12","26","13","false","18122","4.846153846153846","13","13","false","0","18122","516976938"
"7.184989174885735","0.0","0.13917905450649523","1.0","13","8","4","false","1699","7.5","4","4","false","0","1699","0"
"6.901130623045465","0.14876460732631855","0.1449037925264919","0.7333333333333333","13","12","6","false","2303","6.666666666666667","6","6","false","0","2303","33786359"
"6.308395477507818","0.0","0.1585189139719341","1.0","12","8","4","false","7878","6.75","4","4","false","0","7878","0"
"6.178975222516238","2.9948843506393055","0.16183913415868567","0.42857142857142855","12","16","8","false","8541","7.125","8","8","false","0","8541","428468749"
"7.009141207601636","0.0","0.1426708309022892","1.0","13","6","3","false","8593","7.333333333333333","3","3","false","0","8593","0"
"6.308395477507818","0.0","0.1585189139719341","1.0","12","8","4","false","17575","6.75","4","4","false","0","17575","0"
"6.308395477507818","0.0","0.1585189139719341","1.0","12","8","4","false","17683","6.75","4","4","false","0","17683","0"
"7.008900649506856","0.0294350762319543","0.1426757276221856","0.6666666666666666","13","8","4","false","17923","7.0","4","4","false","0","17923","2941598"
"6.900890064950685","0.22769900993434997","0.1449088437271238","0.5714285714285714","13","14","7","false","18771","6.142857142857143","7","7","false","0","18771","46533962"
"6.901611739235025","0.0","0.14489369118159637","1.0","13","8","4","false","24593","8.5","4","4","false","0","24593","0"
"7.184989174885735","0.0","0.13917905450649523","1.0","13","8","4","false","25875","7.5","4","4","false","0","25875","0"
"7.5001202790473895","0.0","0.13333119507344923","1.0","14","6","3","false","12645","4.0","3","3","false","0","12645","0"
"7.5001202790473895","0.0","0.13333119507344923","1.0","14","6","3","false","16803","4.0","3","3","false","0","16803","0"
"6.264854462352658","0.0","0.1596206274238759","0.0","12","2","1","false","12749","8.0","1","1","false","0","12749","0"
"6.074091893192206","0.0","0.16463366336633664","1.0","12","4","2","false","16819","6.5","2","2","false","0","16819","0"
"5.961751262929997","0.01769339496216523","0.16773594802889077","0.6666666666666666","11","6","3","false","24034","7.0","3","3","false","0","24034","2559412"
"6.537166225643493","0.0","0.15297148114075437","1.0","12","4","2","false","17861","5.5","2","2","false","0","17861","0"
"6.985085398123647","0.0","0.14316217240073012","0.0","12","2","1","false","5415","2.0","1","1","false","0","5415","0"
"6.949482800096224","0.0","0.1438956004015369","1.0","12","4","2","false","4380","3.5","2","2","false","0","4380","0"
"6.949482800096224","0.0","0.1438956004015369","1.0","12","4","2","false","16756","3.5","2","2","false","0","16756","0"
"1.0","0.0","1.0","0.0","1","2","1","false","3100","1.0","1","1","false","0","3100","0"
"1.0","0.0","1.0","0.0","1","2","1","false","18098","1.0","1","1","false","0","18098","0"
"5.63170555689199","0.0","0.17756610140532228","0.0","11","2","1","false","16729","20.0","1","1","false","0","16729","0"
"5.63146499879721","0.0","0.1775736864587783","1.0","11","4","2","false","2049","11.0","2","2","false","0","2049","0"
"5.63146499879721","0.0","0.1775736864587783","1.0","11","4","2","false","9915","11.0","2","2","false","0","9915","0"
"1.0","0.0","1.0","0.0","1","2","1","false","19380","1.0","1","1","false","0","19380","0"
"1.0","0.0","1.0","0.0","1","2","1","false","1695","1.0","1","1","false","0","1695","0"
"6.179696896800578","0.0","0.16182023434154696","1.0","12","4","2","false","1825","6.0","2","2","false","0","1825","0"
"6.362761606928073","0.0","0.15716446124763706","1.0","12","4","2","false","6226","4.5","2","2","false","0","6226","0"
"6.362761606928073","0.0","0.15716446124763706","1.0","12","4","2","false","14317","4.5","2","2","false","0","14317","0"
"6.363002165022853","0.0","0.15715851952667195","0.0","12","2","1","false","20775","7.0","1","1","false","0","20775","0"
"7.270627856627375","0.0","0.1375397035468502","0.0","13","2","1","false","4469","4.0","1","1","false","0","4469","0"
"1.0","0.0","1.0","1.0","1","4","2","false","9618","2.0","2","2","false","0","9618","0"
"1.0","0.0","1.0","1.0","1","4","2","false","11285","2.0","2","2","false","0","11285","0"
"1.0","0.0","1.0","1.0","1","4","2","false","12193","2.0","2","2","false","0","12193","0"
"6.661053644455136","1.2087285158796452","0.15012639942217407","0.3333333333333333","12","8","4","false","2306","3.75","4","4","false","0","2306","70897525"
"7.038970411354342","0.0","0.14206623150268277","1.0","13","4","2","false","10514","5.0","2","2","false","0","10514","0"
"7.6420495549675245","0.0","0.130854948375724","1.0","13","6","3","false","3964","5.333333333333333","3","3","false","0","3964","0"
"7.642290113062304","0.0","0.13085082942491108","1.0","13","4","2","false","4018","7.5","2","2","false","0","4018","0"
"7.6420495549675245","0.0","0.130854948375724","1.0","13","6","3","false","9414","5.333333333333333","3","3","false","0","9414","0"
"7.6420495549675245","0.0","0.130854948375724","1.0","13","6","3","false","12640","5.333333333333333","3","3","false","0","12640","0"
"6.676208804426269","0.0","0.1497856087630166","1.0","12","6","3","false","16608","7.666666666666667","3","3","false","0","16608","0"
"7.60740918931922","0.0","0.13145079686314193","0.0","13","2","1","false","16800","5.0","1","1","false","0","16800","0"
"1.4","0.325","0.7142857142857143","0.6666666666666666","2","6","3","false","4051","3.0","3","3","false","0","4051","13"
"1.8","0.0","0.5555555555555556","1.0","3","4","2","false","21187","3.5","2","2","false","0","21187","0"
"1.4","1.5","0.7142857142857143","0.3333333333333333","2","6","3","false","21313","2.6666666666666665","3","3","false","0","21313","36"
"1.2","1.475","0.8333333333333334","0.3333333333333333","2","8","4","false","26092","2.25","4","4","false","0","26092","36"
"2.0","0.0","0.5","0.0","3","2","1","false","11879","4.0","1","1","false","0","11879","0"
"2.2","0.0","0.45454545454545453","0.0","3","2","1","false","21310","3.0","1","1","false","0","21310","0"
"6.147221554005292","0.0","0.16267511935509119","0.0","11","2","1","false","2803","8.0","1","1","false","0","2803","0"
"7.507577579985567","0.0","0.13319875676888077","0.0","13","2","1","false","2295","3.0","1","1","false","0","2295","0"
"7.507577579985567","0.0","0.13319875676888077","0.0","13","2","1","false","5826","3.0","1","1","false","0","5826","0"
"6.2874669232619675","4.46147506490467","0.15904656234456901","0.3333333333333333","13","12","6","false","22","4.0","6","6","false","0","22","438544526"
"6.290113062304546","0.0","0.15897965427566163","1.0","13","6","3","false","11183","5.0","3","3","false","0","11183","0"
"6.837142169834015","0.633831393549107","0.1462599394834987","0.3333333333333333","13","6","3","false","19440","4.0","3","3","false","0","19440","60020264"
"7.284580226124609","0.7802524533084753","0.13727626973119345","0.6666666666666666","14","8","4","false","22618","4.25","4","4","false","0","22618","105564928"
"7.237430839547751","1.4978195083101562","0.138170577677325","0.4","14","10","5","false","25043","3.8","5","5","false","0","25043","168345603"
"1.0","0.0","1.0","0.0","1","2","1","false","3074","1.0","1","1","false","0","3074","0"
"1.0","0.0","1.0","0.0","1","2","1","false","23416","1.0","1","1","false","0","23416","0"
"6.724801539571806","0.0","0.1487032731175103","1.0","13","4","2","false","1101","3.0","2","2","false","0","1101","0"
"5.725282655761366","2.0468637961919582","0.1746638655462185","0.3333333333333333","12","8","4","false","9030","8.0","4","4","false","0","9030","146186590"
"6.724801539571806","0.0","0.1487032731175103","1.0","13","4","2","false","17854","3.0","2","2","false","0","17854","0"
"7.685350012027905","0.0","0.13011769124827846","1.0","14","4","2","false","22487","3.5","2","2","false","0","22487","0"
"7.685350012027905","0.0","0.13011769124827846","1.0","14","4","2","false","25891","3.5","2","2","false","0","25891","0"
"6.462833774356507","0.0","0.15473088662249684","0.0","12","2","1","false","1823","11.0","1","1","false","0","1823","0"
"6.462593216261727","0.0","0.15473664619393263","1.0","12","4","2","false","2003","7.0","2","2","false","0","2003","0"
"6.462833774356507","0.0","0.15473088662249684","0.0","12","2","1","false","22031","11.0","1","1","false","0","22031","0"
"6.997594419052201","0.0","0.14290625322286774","1.0","13","6","3","false","885","3.3333333333333335","3","3","false","0","885","0"
"6.997594419052201","0.0","0.14290625322286774","1.0","13","6","3","false","2505","3.3333333333333335","3","3","false","0","2505","0"
"6.997594419052201","0.0","0.14290625322286774","1.0","13","6","3","false","17192","3.3333333333333335","3","3","false","0","17192","0"
"1.0","0.0","1.0","0.0","1","2","1","false","19911","1.0","1","1","false","0","19911","0"
"1.0","0.0","1.0","0.0","1","2","1","false","25487","1.0","1","1","false","0","25487","0"
"1.0","2.5","1.0","0.0","1","4","2","false","6229","1.0","2","2","false","0","6229","5"
"1.5","0.0","0.6666666666666666","0.0","2","2","1","false","6423","2.0","1","1","false","0","6423","0"
"1.5","0.0","0.6666666666666666","0.0","2","2","1","false","7647","2.0","1","1","false","0","7647","0"
"6.104883329324032","0.0","0.1638032941918197","1.0","12","6","3","false","1966","5.333333333333333","3","3","false","0","1966","0"
"6.104883329324032","0.0","0.1638032941918197","1.0","12","6","3","false","8048","5.333333333333333","3","3","false","0","8048","0"
"6.104883329324032","0.0","0.1638032941918197","1.0","12","6","3","false","15717","5.333333333333333","3","3","false","0","15717","0"
"1.0","0.0","1.0","0.0","1","2","1","false","10847","1.0","1","1","false","0","10847","0"
"1.0","0.0","1.0","0.0","1","2","1","false","10148","1.0","1","1","false","0","10148","0"
"6.399807553524176","9.712518085268698","0.1562546985415727","0.3333333333333333","12","6","3","false","4875","3.6666666666666665","3","3","false","0","4875","706780363"
"6.549434688477267","0.9192511639781943","0.15268493351942997","0.5","12","18","9","false","4488","11.0","9","9","false","0","4488","164915875"
"6.975463074332452","0.0","0.14335965789564437","0.0","13","2","1","false","15913","16.0","1","1","false","0","15913","0"
"1.4285714285714286","1.8333333333333333","0.7","0.3333333333333333","2","8","4","false","11009","2.75","4","4","false","0","11009","77"
"2.142857142857143","0.0","0.4666666666666667","1.0","3","4","2","false","20157","3.0","2","2","false","0","20157","0"
"1.2857142857142858","2.8571428571428568","0.7777777777777777","0.4","2","10","5","false","21344","3.0","5","5","false","0","21344","120"
"1.7142857142857142","0.0","0.5833333333333334","1.0","2","4","2","false","22990","4.5","2","2","false","0","22990","0"
"2.142857142857143","0.0","0.4666666666666667","1.0","3","4","2","false","23471","3.0","2","2","false","0","23471","0"
"1.0","2.5","1.0","0.0","1","4","2","false","3206","1.0","2","2","false","0","3206","5"
"1.5","0.0","0.6666666666666666","0.0","2","2","1","false","6535","2.0","1","1","false","0","6535","0"
"1.5","0.0","0.6666666666666666","0.0","2","2","1","false","6579","2.0","1","1","false","0","6579","0"
"6.264132788068318","0.0","0.15963901689708143","1.0","12","4","2","false","2386","5.0","2","2","false","0","2386","0"
"8.30695212893914","0.0","0.12038109579520444","0.0","14","2","1","false","16941","2.0","1","1","false","0","16941","0"
"6.966081308636036","2.545432834397168","0.14355273154223358","0.3333333333333333","12","8","4","false","8446","2.75","4","4","false","0","8446","179275766"
"6.5095020447438054","0.0","0.15362158167036216","0.0","12","2","1","false","18597","9.0","1","1","false","0","18597","0"
"6.387057974500842","0.8933826537252514","0.1565666076607284","0.3333333333333333","12","14","7","false","11502","4.0","7","7","false","0","11502","104084973"
"6.5085398123646865","0.0","0.15364429331756357","1.0","12","6","3","false","11903","6.666666666666667","3","3","false","0","11903","0"
"6.5095020447438054","0.0","0.15362158167036216","0.0","12","2","1","false","12157","9.0","1","1","false","0","12157","0"
"6.388020206879961","0.0","0.15654302391263417","1.0","12","6","3","false","12158","7.333333333333333","3","3","false","0","12158","0"
"6.5082992542699065","0.22029962725369592","0.15364997227869154","0.6666666666666666","12","8","4","false","24210","5.25","4","4","false","0","24210","44169838"
"1.0","2.5","1.0","0.0","1","4","2","false","12290","1.0","2","2","false","0","12290","5"
"1.5","0.0","0.6666666666666666","0.0","2","2","1","false","17307","2.0","1","1","false","0","17307","0"
"1.5","0.0","0.6666666666666666","0.0","2","2","1","false","20031","2.0","1","1","false","0","20031","0"
"6.365888862160212","0.0","0.15708725390167402","0.0","12","2","1","false","1860","5.0","1","1","false","0","1860","0"
"8.278325715660332","0.0","0.12079737308575249","0.0","14","2","1","false","3073","2.0","1","1","false","0","3073","0"
"6.842434447919173","0.0","0.14614681479398114","0.0","12","2","1","false","4000","4.0","1","1","false","0","4000","0"
"2.0","0.0","0.5","0.0","3","2","1","false","17173","4.0","1","1","false","0","17173","0"
"5.8537406783738275","0.0","0.17083093613873593","1.0","12","4","2","false","3685","11.0","2","2","false","0","3685","0"
"1.0","0.0","1.0","0.0","1","2","1","false","25853","1.0","1","1","false","0","25853","0"
"1.0","0.0","1.0","0.0","1","2","1","false","8404","1.0","1","1","false","0","8404","0"
"1.0","0.0","1.0","0.0","1","2","1","false","25","1.0","1","1","false","0","25","0"
"1.0","0.0","1.0","0.0","1","2","1","false","22891","1.0","1","1","false","0","22891","0"
"1.6666666666666667","0.0","0.6","0.0","2","2","1","false","28","3.0","1","1","false","0","28","0"
"1.0","1.8333333333333333","1.0","0.3333333333333333","1","6","3","false","7916","1.6666666666666667","3","3","false","0","7916","11"
"1.3333333333333333","0.0","0.75","1.0","2","4","2","false","21515","2.5","2","2","false","0","21515","0"
"1.3333333333333333","0.0","0.75","1.0","2","4","2","false","21523","2.5","2","2","false","0","21523","0"
"6.586240076978591","0.0","0.15183169582526754","1.0","12","6","3","false","4656","4.666666666666667","3","3","false","0","4656","0"
"6.586240076978591","0.0","0.15183169582526754","1.0","12","6","3","false","18196","4.666666666666667","3","3","false","0","18196","0"
"6.586240076978591","0.0","0.15183169582526754","1.0","12","6","3","false","23303","4.666666666666667","3","3","false","0","23303","0"
"5.58696175126293","6.813894539470165","0.1789881593110872","0.25","11","16","8","false","24841","6.375","8","8","false","0","24841","1002048928"
"6.586240076978591","0.0","0.15183169582526754","1.0","12","6","3","false","4265","5.0","3","3","false","0","4265","0"
"6.586240076978591","0.0","0.15183169582526754","1.0","12","6","3","false","5267","5.0","3","3","false","0","5267","0"
"6.585999518883811","2.2756355862058107E-4","0.1518372415808313","0.6666666666666666","12","8","4","false","5271","4.0","4","4","false","0","5271","7863"
"6.58648063507337","0.0","0.15182615047479914","1.0","12","4","2","false","7597","6.0","2","2","false","0","7597","0"
"6.418089968727448","0.0","0.1558095952023988","1.0","12","4","2","false","7638","5.0","2","2","false","0","7638","0"
"6.418089968727448","0.0","0.1558095952023988","1.0","12","4","2","false","7648","5.0","2","2","false","0","7648","0"
"7.396199182102478","8.749769918569116","0.1352045794574904","0.3333333333333333","13","6","3","false","11844","3.0","3","3","false","0","11844","636763947"
"8.39451527543902","0.0","0.11912540119211369","1.0","14","4","2","false","7854","3.5","2","2","false","0","7854","0"
"7.821265335578542","0.0","0.12785654968781718","1.0","13","4","2","false","1668","19.0","2","2","false","0","1668","0"
"7.821265335578542","0.0","0.12785654968781718","1.0","13","4","2","false","4835","19.0","2","2","false","0","4835","0"
"8.634832812124127","0.0","0.11581000139295167","0.0","14","2","1","false","15007","2.0","1","1","false","0","15007","0"
"1.0","0.0","1.0","0.0","1","2","1","false","10559","1.0","1","1","false","0","10559","0"
"1.0","0.0","1.0","0.0","1","2","1","false","18245","1.0","1","1","false","0","18245","0"
"6.558094779889343","0.8774946325909218","0.15248331010197344","0.0","12","4","2","false","10445","2.5","2","2","false","0","10445","67447021"
"7.557854221794563","0.0","0.1323126869947164","0.0","13","2","1","false","21594","2.0","1","1","false","0","21594","0"
"6.1991821024777485","0.01525522707878532","0.1613116026387272","0.6666666666666666","11","6","3","false","22738","5.0","3","3","false","0","22738","1654554"
"1.0","0.0","1.0","1.0","1","4","2","false","6389","2.0","2","2","false","0","6389","0"
"1.0","0.0","1.0","1.0","1","4","2","false","6914","2.0","2","2","false","0","6914","0"
"1.0","0.0","1.0","1.0","1","4","2","false","18279","2.0","2","2","false","0","18279","0"
"1.0","0.0","1.0","0.0","1","2","1","false","7468","1.0","1","1","false","0","7468","0"
"1.0","0.0","1.0","0.0","1","2","1","false","10002","1.0","1","1","false","0","10002","0"
"1.0","0.0","1.0","0.0","1","2","1","false","12041","1.0","1","1","false","0","12041","0"
"1.0","0.0","1.0","0.0","1","2","1","false","14384","1.0","1","1","false","0","14384","0"
"6.666827038729854","0.0","0.1499963917153785","0.0","12","2","1","false","17341","4.0","1","1","false","0","17341","0"
"6.666827038729854","0.0","0.1499963917153785","0.0","12","2","1","false","24470","4.0","1","1","false","0","24470","0"
"6.025258599951888","0.0","0.16596798019722922","0.0","12","2","1","false","15186","7.0","1","1","false","0","15186","0"
"1.75","0.0","0.5714285714285714","1.0","3","4","2","false","8443","2.5","2","2","false","0","8443","0"
"1.75","0.0","0.5714285714285714","1.0","3","4","2","false","15248","2.5","2","2","false","0","15248","0"
"6.974500841953332","0.0","0.14337943641568654","1.0","13","6","3","false","13683","5.333333333333333","3","3","false","0","13683","0"
"6.974260283858552","0.8597018422489936","0.14338438189845473","0.5","13","8","4","false","21203","4.0","4","4","false","0","21203","66810350"
"6.974500841953332","0.0","0.14337943641568654","1.0","13","6","3","false","21778","5.333333333333333","3","3","false","0","21778","0"
"7.974019725763772","0.0","0.12540726439000846","0.0","14","2","1","false","26042","4.0","1","1","false","0","26042","0"
"6.975222516237672","0.0","0.1433646020140709","0.0","13","2","1","false","3451","9.0","1","1","false","0","3451","0"
"6.23959586240077","0.0","0.1602667900377824","1.0","12","4","2","false","7038","11.5","2","2","false","0","7038","0"
"1.0","0.0","1.0","0.0","1","2","1","false","17951","1.0","1","1","false","0","17951","0"
"1.0","0.0","1.0","0.0","1","2","1","false","833","1.0","1","1","false","0","833","0"
"6.429636757276882","0.0","0.15552978150254415","1.0","12","6","3","false","2810","9.0","3","3","false","0","2810","0"
"6.429877315371662","0.0","0.15552396273710203","1.0","12","4","2","false","18145","8.5","2","2","false","0","18145","0"
"6.429877315371662","0.0","0.15552396273710203","1.0","12","4","2","false","21799","8.5","2","2","false","0","21799","0"
"5.9160452249218185","1.4192208453510822","0.16903183832797952","0.16666666666666666","12","8","4","false","192","9.0","4","4","false","0","192","119798926"
"1.0","0.0","1.0","1.0","1","4","2","false","4826","2.0","2","2","false","0","4826","0"
"1.0","0.0","1.0","1.0","1","4","2","false","4021","2.0","2","2","false","0","4021","0"
"1.0","0.0","1.0","1.0","1","4","2","false","26022","2.0","2","2","false","0","26022","0"
"1.0","0.0","1.0","0.0","1","2","1","false","6161","1.0","1","1","false","0","6161","0"
"1.0","0.0","1.0","0.0","1","2","1","false","7055","1.0","1","1","false","0","7055","0"
"2.1666666666666665","0.0","0.46153846153846156","0.0","3","2","1","false","19712","4.0","1","1","false","0","19712","0"
"1.3333333333333333","2.5666666666666664","0.75","0.16666666666666666","2","8","4","false","21024","2.0","4","4","false","0","21024","77"
"2.1666666666666665","0.0","0.46153846153846156","0.0","3","2","1","false","8071","4.0","1","1","false","0","8071","0"
"1.3333333333333333","2.1333333333333333","0.75","0.3333333333333333","2","8","4","false","17178","2.5","4","4","false","0","17178","64"
"1.6666666666666667","0.0","0.6","1.0","2","4","2","false","23215","4.0","2","2","false","0","23215","0"
"1.0","0.0","1.0","1.0","1","4","2","false","3062","2.0","2","2","false","0","3062","0"
"1.0","0.0","1.0","1.0","1","4","2","false","16892","2.0","2","2","false","0","16892","0"
"1.0","0.0","1.0","1.0","1","4","2","false","19572","2.0","2","2","false","0","19572","0"
"6.734423863363002","0.8447946492841255","0.1484908019289159","0.0","12","4","2","false","7857","2.0","2","2","false","0","7857","62399925"
"7.734183305268222","0.0","0.12929613386830893","0.0","13","2","1","false","11968","2.0","1","1","false","0","11968","0"
"5.9865287466923265","0.0","0.16704171019850517","1.0","12","4","2","false","19810","5.5","2","2","false","0","19810","0"
"6.739956699542939","0.0","0.14836890570347633","0.0","12","2","1","false","14841","5.0","1","1","false","0","14841","0"
"6.170315131104162","0.13179206446618705","0.1620662768031189","0.0","11","4","2","false","920","4.5","2","2","false","0","920","7387071"
"7.728169352898725","0.0","0.12939675029571066","0.0","12","2","1","false","25904","5.0","1","1","false","0","25904","0"
"8.236709165263411","0.0","0.12140771028037382","1.0","15","6","3","false","25829","4.0","3","3","false","0","25829","0"
"8.236709165263411","0.0","0.12140771028037382","1.0","15","6","3","false","25849","4.0","3","3","false","0","25849","0"
"7.700264613904258","1.490908408493493","0.12986566697906904","0.0","14","6","3","false","13355","3.3333333333333335","3","3","false","0","13355","131346047"
"1.0","0.0","1.0","0.0","1","2","1","false","13022","1.0","1","1","false","0","13022","0"
"1.0","0.0","1.0","0.0","1","2","1","false","8077","1.0","1","1","false","0","8077","0"
"1.0","0.0","1.0","0.0","1","2","1","false","6300","1.0","1","1","false","0","6300","0"
"1.0","0.0","1.0","0.0","1","2","1","false","2117","1.0","1","1","false","0","2117","0"
"6.416646620158768","0.0","0.1558446427232511","1.0","12","4","2","false","5182","6.0","2","2","false","0","5182","0"
"6.416646620158768","0.0","0.1558446427232511","1.0","12","4","2","false","13311","6.0","2","2","false","0","13311","0"
"6.416887178253548","0.0","0.15583880037488285","0.0","12","2","1","false","1879","10.0","1","1","false","0","1879","0"
"6.416887178253548","0.0","0.15583880037488285","0.0","12","2","1","false","21548","10.0","1","1","false","0","21548","0"
"1.0","0.0","1.0","0.0","1","2","1","false","21809","1.0","1","1","false","0","21809","0"
"1.0","0.0","1.0","0.0","1","2","1","false","15609","1.0","1","1","false","0","15609","0"
"6.903536203993264","1.6354243674005116","0.14485329988152484","0.3333333333333333","12","6","3","false","21177","2.3333333333333335","3","3","false","0","21177","120392886"
"7.903055087803705","0.0","0.12653334550878154","1.0","13","4","2","false","1174","2.5","2","2","false","0","1174","0"
"7.903055087803705","0.0","0.12653334550878154","1.0","13","4","2","false","2712","2.5","2","2","false","0","2712","0"
"6.346884772672601","0.0","0.15755761067313523","1.0","13","4","2","false","14176","6.5","2","2","false","0","14176","0"
"1.0","0.0","1.0","0.0","1","2","1","false","21018","1.0","1","1","false","0","21018","0"
"1.0","0.0","1.0","0.0","1","2","1","false","5479","1.0","1","1","false","0","5479","0"
"1.0","0.0","1.0","1.0","1","4","2","false","16124","2.0","2","2","false","0","16124","0"
"1.0","0.0","1.0","1.0","1","4","2","false","20807","2.0","2","2","false","0","20807","0"
"1.0","0.0","1.0","1.0","1","4","2","false","24334","2.0","2","2","false","0","24334","0"
"7.075535241760885","0.0","0.14133206405330975","1.0","13","12","6","false","16415","6.666666666666667","6","6","false","0","16415","0"
"7.075535241760885","0.0","0.14133206405330975","1.0","13","12","6","false","7046","6.666666666666667","6","6","false","0","7046","0"
"7.075535241760885","0.0","0.14133206405330975","1.0","13","12","6","false","14710","6.666666666666667","6","6","false","0","14710","0"
"7.075535241760885","0.0","0.14133206405330975","1.0","13","12","6","false","15682","6.666666666666667","6","6","false","0","15682","0"
"7.075535241760885","0.0","0.14133206405330975","1.0","13","12","6","false","17157","6.666666666666667","6","6","false","0","17157","0"
"7.075535241760885","0.0","0.14133206405330975","1.0","13","12","6","false","23093","6.666666666666667","6","6","false","0","23093","0"
"5.60716863122444","0.0","0.17834312926337467","1.0","11","6","3","false","21547","36.666666666666664","3","3","false","0","21547","0"
"6.538609574212172","1.6637448720303702","0.15293771384422944","0.4722222222222222","13","18","9","false","15357","5.444444444444445","9","9","false","0","15357","96779718"
"6.539331248496512","0.0","0.15292083578575633","1.0","13","12","6","false","6076","7.5","6","6","false","0","6076","0"
"6.539331248496512","0.0","0.15292083578575633","1.0","13","12","6","false","7311","7.5","6","6","false","0","7311","0"
"7.538128458022612","0.0","0.1326589226448813","1.0","14","4","2","false","8629","5.5","2","2","false","0","8629","0"
"6.539331248496512","0.0","0.15292083578575633","1.0","13","12","6","false","12615","7.5","6","6","false","0","12615","0"
"6.539331248496512","0.0","0.15292083578575633","1.0","13","12","6","false","15163","7.5","6","6","false","0","15163","0"
"7.538128458022612","0.0","0.1326589226448813","1.0","14","4","2","false","16483","5.5","2","2","false","0","16483","0"
"5.861919653596344","3.2456815721798136","0.1705925804333552","0.7142857142857143","12","14","7","false","17731","7.142857142857143","7","7","false","0","17731","191920000"
"6.841712773634833","2.116749164124291E-4","0.1461622305826096","0.6666666666666666","13","6","3","false","18913","7.333333333333333","3","3","false","0","18913","7314"
"6.842434447919173","0.0","0.14614681479398114","1.0","13","4","2","false","13990","7.0","2","2","false","0","13990","0"
"5.772191484243445","0.0","0.1732444259220671","1.0","11","4","2","false","4555","11.5","2","2","false","0","4555","0"
"1.5","0.0","0.6666666666666666","0.0","2","2","1","false","7482","2.0","1","1","false","0","7482","0"
"1.0","2.5","1.0","0.0","1","4","2","false","15681","1.0","2","2","false","0","15681","5"
"1.5","0.0","0.6666666666666666","0.0","2","2","1","false","20793","2.0","1","1","false","0","20793","0"
"6.962713495309117","0.3892969417634089","0.14362216694306246","0.5","13","10","5","false","10346","3.8","5","5","false","0","10346","69883995"
"6.963194611498677","0.38889500831534546","0.14361224348787396","0.6666666666666666","13","6","3","false","15687","5.0","3","3","false","0","15687","69874733"
"6.963194611498677","0.0","0.14361224348787396","1.0","13","6","3","false","19143","5.333333333333333","3","3","false","0","19143","0"
"6.963194611498677","0.0","0.14361224348787396","1.0","13","6","3","false","19383","5.333333333333333","3","3","false","0","19383","0"
"7.962232379119557","0.0","0.1255929182150518","1.0","14","4","2","false","6291","4.0","2","2","false","0","6291","0"
"7.232138561462593","0.0","0.13827168706758916","0.0","12","2","1","false","19223","2.0","1","1","false","0","19223","0"
"7.23863363002165","0.0","0.1381476188893689","1.0","12","4","2","false","19739","3.0","2","2","false","0","19739","0"
"7.23863363002165","0.0","0.1381476188893689","1.0","12","4","2","false","20568","3.0","2","2","false","0","20568","0"
"6.600192446475824","0.0","0.151510733680796","0.0","12","2","1","false","8452","3.0","1","1","false","0","8452","0"
"6.148664902573971","0.689999671033092","0.16263693270735524","0.42857142857142855","12","14","7","false","22233","5.285714285714286","7","7","false","0","22233","89445393"
"6.3933124849651195","0.0","0.15641344019264777","1.0","12","8","4","false","12612","7.25","4","4","false","0","12612","0"
"6.540774597065191","0.0","0.1528870908422214","1.0","13","6","3","false","14843","5.0","3","3","false","0","14843","0"
"6.3933124849651195","0.0","0.15641344019264777","1.0","12","8","4","false","19208","7.25","4","4","false","0","19208","0"
"6.540774597065191","0.0","0.1528870908422214","1.0","13","6","3","false","20569","5.0","3","3","false","0","20569","0"
"1.0","0.0","1.0","0.0","1","2","1","false","17585","1.0","1","1","false","0","17585","0"
"1.0","0.0","1.0","0.0","1","2","1","false","15218","1.0","1","1","false","0","15218","0"
"5.676449362521049","0.13502232959696606","0.1761664618383693","0.3333333333333333","11","6","3","false","19703","6.0","3","3","false","0","19703","11438364"
"1.0","0.0","1.0","0.0","1","2","1","false","7957","1.0","1","1","false","0","7957","0"
"1.0","0.0","1.0","0.0","1","2","1","false","18895","1.0","1","1","false","0","18895","0"
"6.545345200866009","2.2782941699043993","0.15278033003785513","0.26666666666666666","12","12","6","false","4825","3.8333333333333335","6","6","false","0","4825","171454643"
"7.545104642771229","0.0","0.13253626653913597","0.0","13","2","1","false","8037","6.0","1","1","false","0","8037","0"
"6.545826317055569","0.7563110034143505","0.15276910073132188","0.5","12","8","4","false","9593","5.25","4","4","false","0","9593","56908683"
"7.544864084676449","0.0","0.13254049228414744","1.0","13","4","2","false","14621","4.0","2","2","false","0","14621","0"
"7.544864084676449","0.0","0.13254049228414744","1.0","13","4","2","false","19608","4.0","2","2","false","0","19608","0"
"6.547269665624248","0.0","0.1527354227137451","1.0","12","4","2","false","15250","7.0","2","2","false","0","15250","0"
"6.547269665624248","0.0","0.1527354227137451","1.0","12","4","2","false","15589","7.0","2","2","false","0","15589","0"
"7.545585758960789","0.0","0.1325278158574298","0.0","13","2","1","false","4836","4.0","1","1","false","0","4836","0"
"6.273755111859514","0.0","0.15939417177914111","0.0","12","2","1","false","11898","9.0","1","1","false","0","11898","0"
"6.271590089006495","1.545230189091628","0.1594491964251467","0.42857142857142855","12","14","7","false","1028","5.142857142857143","7","7","false","0","1028","199139601"
"6.253548231898003","0.006070174416186118","0.15990921680258502","0.9","12","10","5","false","9924","7.4","5","5","false","0","9924","840860"
"6.253548231898003","0.006070174416186118","0.15990921680258502","0.9","12","10","5","false","12262","7.4","5","5","false","0","12262","840860"
"1.0","0.0","1.0","0.0","1","2","1","false","15181","1.0","1","1","false","0","15181","0"
"1.0","0.0","1.0","0.0","1","2","1","false","2331","1.0","1","1","false","0","2331","0"
"1.0","0.0","1.0","1.0","1","4","2","false","17461","2.0","2","2","false","0","17461","0"
"1.0","0.0","1.0","1.0","1","4","2","false","188","2.0","2","2","false","0","188","0"
"1.0","0.0","1.0","1.0","1","4","2","false","22920","2.0","2","2","false","0","22920","0"
"1.0","0.0","1.0","0.0","1","2","1","false","373","1.0","1","1","false","0","373","0"
"1.0","0.0","1.0","0.0","1","2","1","false","21579","1.0","1","1","false","0","21579","0"
"9.246090930959827","0.0","0.10815381413258403","1.0","14","4","2","false","23775","2.5","2","2","false","0","23775","0"
"9.246090930959827","0.0","0.10815381413258403","1.0","14","4","2","false","11012","2.5","2","2","false","0","11012","0"
"5.979312003848929","0.3930043527639125","0.16724332153202445","0.3333333333333333","11","6","3","false","8198","5.0","3","3","false","0","8198","26355107"
"5.89054606687515","0.9643564596387385","0.1697635480050639","0.3333333333333333","11","8","4","false","13010","4.25","4","4","false","0","13010","66496628"
"5.704113543420736","0.04400007813130851","0.1753120782726046","0.3333333333333333","12","12","6","false","320","6.166666666666667","6","6","false","0","320","4976468"
"5.755111859514073","0.0","0.1737585688012038","1.0","12","4","2","false","1897","13.0","2","2","false","0","1897","0"
"5.755111859514073","0.0","0.1737585688012038","1.0","12","4","2","false","5602","14.0","2","2","false","0","5602","0"
"5.755111859514073","0.0","0.1737585688012038","1.0","12","4","2","false","6024","14.0","2","2","false","0","6024","0"
"5.755111859514073","0.0","0.1737585688012038","1.0","12","4","2","false","17464","14.0","2","2","false","0","17464","0"
"5.755111859514073","0.0","0.1737585688012038","1.0","12","4","2","false","17590","13.0","2","2","false","0","17590","0"
"5.754630743324513","1.7081013900275587E-4","0.17377309589499207","0.5","12","8","4","false","18042","8.0","4","4","false","0","18042","5902"
"5.755352417608853","0.0","0.17375130616509926","0.0","12","2","1","false","21315","22.0","1","1","false","0","21315","0"
"5.755352417608853","0.0","0.17375130616509926","0.0","12","2","1","false","22770","22.0","1","1","false","0","22770","0"
"7.2874669232619675","0.0","0.1372218921238529","1.0","13","4","2","false","5483","5.0","2","2","false","0","5483","0"
"7.2874669232619675","0.0","0.1372218921238529","1.0","13","4","2","false","18884","5.0","2","2","false","0","18884","0"
"7.2874669232619675","0.0","0.1372218921238529","1.0","13","4","2","false","22727","5.0","2","2","false","0","22727","0"
"7.123165744527303","0.0","0.1403870183377799","0.0","12","2","1","false","2487","5.0","1","1","false","0","2487","0"
"6.123406302622083","1.0928820214196262","0.16330779807503437","0.4","11","10","5","false","3052","4.0","5","5","false","0","3052","122736577"
"6.123887418811643","0.0","0.16329496798523","1.0","11","6","3","false","6711","6.333333333333333","3","3","false","0","6711","0"
"7.122925186432523","0.0","0.14039175954069572","1.0","12","4","2","false","16232","4.5","2","2","false","0","16232","0"
"6.123646860716863","0.3637400173600057","0.16330138277812697","0.6666666666666666","11","8","4","false","22725","5.0","4","4","false","0","22725","61305830"
"5.712773634832812","0.0","0.17504631969007917","1.0","11","4","2","false","14991","7.5","2","2","false","0","14991","0"
"2.3846153846153846","0.0","0.41935483870967744","1.0","3","4","2","false","20560","5.0","2","2","false","0","20560","0"
"1.0","0.0","1.0","0.0","1","2","1","false","10356","1.0","1","1","false","0","10356","0"
"1.0","0.0","1.0","0.0","1","2","1","false","19062","1.0","1","1","false","0","19062","0"
"6.497955256194371","0.0","0.15389456537835036","0.0","12","2","1","false","8973","8.0","1","1","false","0","8973","0"
"6.497955256194371","0.0","0.15389456537835036","0.0","12","2","1","false","14600","8.0","1","1","false","0","14600","0"
"6.497955256194371","0.0","0.15389456537835036","0.0","12","2","1","false","23138","8.0","1","1","false","0","23138","0"
"8.157806110175608","0.0","0.12258197688133993","1.0","14","4","2","false","4372","3.0","2","2","false","0","4372","0"
"8.157806110175608","0.0","0.12258197688133993","1.0","14","4","2","false","10880","3.0","2","2","false","0","10880","0"
"7.158287226365167","2.158150624559662","0.1396982222670296","0.16666666666666666","13","8","4","false","16598","2.5","4","4","false","0","16598","134035002"
"8.158046668270387","0.0","0.12257836227995164","0.0","14","2","1","false","3851","4.0","1","1","false","0","3851","0"
"6.343516959345682","0.0","0.1576412590064467","0.0","12","2","1","false","7011","8.0","1","1","false","0","7011","0"
"6.343516959345682","0.0","0.1576412590064467","0.0","12","2","1","false","8702","8.0","1","1","false","0","8702","0"
"6.343516959345682","0.0","0.1576412590064467","0.0","12","2","1","false","18159","8.0","1","1","false","0","18159","0"
"6.562424825595381","0.0","0.15238269794721407","0.0","12","2","1","false","15200","5.0","1","1","false","0","15200","0"
"8.008178975222517","0.0","0.12487233403424451","0.0","14","2","1","false","15617","3.0","1","1","false","0","15617","0"
"1.0","0.0","1.0","0.0","1","2","1","false","7807","1.0","1","1","false","0","7807","0"
"1.0","0.0","1.0","0.0","1","2","1","false","11828","1.0","1","1","false","0","11828","0"
"6.380562905941785","0.0","0.15672598401447746","0.0","12","2","1","false","2352","3.0","1","1","false","0","2352","0"
"6.1284580226124605","0.0","0.16317318260323443","1.0","12","4","2","false","1855","9.5","2","2","false","0","1855","0"
"6.1284580226124605","0.0","0.16317318260323443","1.0","12","4","2","false","2527","9.0","2","2","false","0","2527","0"
"6.1284580226124605","0.0","0.16317318260323443","1.0","12","4","2","false","5057","9.5","2","2","false","0","5057","0"
"7.2694250661534765","0.0","0.13756246070353087","0.0","13","2","1","false","7094","2.0","1","1","false","0","7094","0"
"1.0","1.5","1.0","0.0","1","4","2","false","10432","1.0","2","2","false","0","10432","3"
"1.5","0.0","0.6666666666666666","0.0","2","2","1","false","5774","2.0","1","1","false","0","5774","0"
"1.5","0.0","0.6666666666666666","0.0","2","2","1","false","16891","2.0","1","1","false","0","16891","0"
"1.0","0.0","1.0","0.0","1","2","1","false","2624","1.0","1","1","false","0","2624","0"
"1.0","0.0","1.0","0.0","1","2","1","false","24202","1.0","1","1","false","0","24202","0"
"2.5384615384615383","0.0","0.393939393939394","0.0","3","2","1","false","21314","5.0","1","1","false","0","21314","0"
"1.0","0.0","1.0","0.0","1","2","1","false","15572","1.0","1","1","false","0","15572","0"
"1.0","0.0","1.0","0.0","1","2","1","false","7356","1.0","1","1","false","0","7356","0"
"6.4293961991821025","0.0","0.15553560070340855","1.0","12","4","2","false","22556","7.5","2","2","false","0","22556","0"
"6.841953331729613","0.0","0.14615709162506152","0.0","13","2","1","false","19102","7.0","1","1","false","0","19102","0"
"6.306471012749579","0.0","0.15856728715288373","0.0","11","2","1","false","748","4.0","1","1","false","0","748","0"
"1.0","0.0","1.0","0.0","1","2","1","false","8811","1.0","1","1","false","0","8811","0"
"1.0","0.0","1.0","0.0","1","2","1","false","22021","1.0","1","1","false","0","22021","0"
"1.0","0.0","1.0","1.0","1","4","2","false","2332","2.0","2","2","false","0","2332","0"
"1.0","0.0","1.0","1.0","1","4","2","false","18544","2.0","2","2","false","0","18544","0"
"1.0","0.0","1.0","1.0","1","4","2","false","21596","2.0","2","2","false","0","21596","0"
"1.0","0.0","1.0","1.0","1","4","2","false","16783","2.0","2","2","false","0","16783","0"
"1.0","0.0","1.0","1.0","1","4","2","false","15642","2.0","2","2","false","0","15642","0"
"1.0","0.0","1.0","1.0","1","4","2","false","17563","2.0","2","2","false","0","17563","0"
"1.5","0.0","0.6666666666666666","0.0","2","2","1","false","12252","2.0","1","1","false","0","12252","0"
"1.0","2.5","1.0","0.0","1","4","2","false","22404","1.0","2","2","false","0","22404","5"
"1.5","0.0","0.6666666666666666","0.0","2","2","1","false","9026","2.0","1","1","false","0","9026","0"
"1.3333333333333333","0.0","0.75","1.0","2","4","2","false","18669","2.5","2","2","false","0","18669","0"
"1.3333333333333333","0.0","0.75","1.0","2","4","2","false","19866","2.5","2","2","false","0","19866","0"
"1.0","1.5","1.0","0.3333333333333333","1","6","3","false","25545","1.6666666666666667","3","3","false","0","25545","9"
"1.6666666666666667","0.0","0.6","0.0","2","2","1","false","8538","3.0","1","1","false","0","8538","0"
"9.324753427952851","0.0","0.10724144158088898","0.0","15","2","1","false","19450","2.0","1","1","false","0","19450","0"
"1.0","0.0","1.0","0.0","1","2","1","false","7536","1.0","1","1","false","0","7536","0"
"1.0","0.0","1.0","0.0","1","2","1","false","7534","1.0","1","1","false","0","7534","0"
"6.618715419773875","0.0","0.15108671948826052","0.0","12","2","1","false","3383","4.0","1","1","false","0","3383","0"
"1.0","0.0","1.0","0.0","1","2","1","false","1344","1.0","1","1","false","0","1344","0"
"1.0","0.0","1.0","0.0","1","2","1","false","18126","1.0","1","1","false","0","18126","0"
"6.920856386817416","0.0","0.14449078901633647","1.0","13","4","2","false","1322","4.0","2","2","false","0","1322","0"
"6.920615828722637","0.0","0.1444958114637283","1.0","13","6","3","false","10925","4.0","3","3","false","0","10925","0"
"6.920615828722637","0.0","0.1444958114637283","1.0","13","6","3","false","15195","4.0","3","3","false","0","15195","0"
"6.920856386817416","0.0","0.14449078901633647","1.0","13","4","2","false","16068","4.0","2","2","false","0","16068","0"
"6.920615828722637","0.0","0.1444958114637283","1.0","13","6","3","false","17467","4.0","3","3","false","0","17467","0"
"6.845321145056531","0.0","0.1460851841439415","1.0","11","4","2","false","11611","2.5","2","2","false","0","11611","0"
"6.845321145056531","0.0","0.1460851841439415","1.0","11","4","2","false","20779","2.5","2","2","false","0","20779","0"
"7.836901611739235","0.0","0.1276014488304991","0.0","14","2","1","false","24490","3.0","1","1","false","0","24490","0"
"1.6666666666666667","0.0","0.6","0.0","2","2","1","false","4276","3.0","1","1","false","0","4276","0"
"1.0","2.6666666666666665","1.0","0.0","1","6","3","false","24159","1.0","3","3","false","0","24159","16"
"1.6666666666666667","0.0","0.6","0.0","2","2","1","false","717","3.0","1","1","false","0","717","0"
"1.6666666666666667","0.0","0.6","0.0","2","2","1","false","17865","3.0","1","1","false","0","17865","0"
"1.0","0.0","1.0","0.0","1","2","1","false","1376","1.0","1","1","false","0","1376","0"
"1.0","0.0","1.0","0.0","1","2","1","false","4267","1.0","1","1","false","0","4267","0"
"1.6","2.6","0.625","0.0","3","6","3","false","1289","1.3333333333333333","3","3","false","0","1289","52"
"2.4","0.0","0.4166666666666667","0.0","4","2","1","false","1560","3.0","1","1","false","0","1560","0"
"2.4","0.0","0.4166666666666667","0.0","4","2","1","false","4365","3.0","1","1","false","0","4365","0"
"6.744046187154198","0.0","0.14827893704298198","0.0","13","2","1","false","1915","5.0","1","1","false","0","1915","0"
"6.245850372865047","0.0","0.16010630103219842","0.0","12","2","1","false","12263","7.0","1","1","false","0","12263","0"
"1.5","0.0","0.6666666666666666","0.0","2","2","1","false","22000","2.0","1","1","false","0","22000","0"
"1.0","2.0","1.0","0.0","1","4","2","false","25136","1.0","2","2","false","0","25136","4"
"1.5","0.0","0.6666666666666666","0.0","2","2","1","false","15259","2.0","1","1","false","0","15259","0"
"1.0","0.0","1.0","1.0","1","4","2","false","348","2.0","2","2","false","0","348","0"
"1.0","0.0","1.0","1.0","1","4","2","false","5660","2.0","2","2","false","0","5660","0"
"1.0","0.0","1.0","1.0","1","4","2","false","15847","2.0","2","2","false","0","15847","0"
"7.787346644214578","0.0","0.12841344371679228","0.0","13","2","1","false","16155","4.0","1","1","false","0","16155","0"
"8.708684147221554","0.0","0.11482791006021767","0.0","14","2","1","false","315","2.0","1","1","false","0","315","0"
"7.36829444310801","1.8152591394132558","0.1357166176950702","0.16666666666666666","13","8","4","false","5629","2.0","4","4","false","0","5629","138698848"
"8.36805388501323","0.0","0.11950209854539183","0.0","14","2","1","false","10499","4.0","1","1","false","0","10499","0"
"8.367813326918451","0.0","0.11950553399453787","1.0","14","4","2","false","16718","3.0","2","2","false","0","16718","0"
"8.367813326918451","0.0","0.11950553399453787","1.0","14","4","2","false","25599","3.0","2","2","false","0","25599","0"
"1.0","0.0","1.0","1.0","1","4","2","false","11969","2.0","2","2","false","0","11969","0"
"1.0","0.0","1.0","1.0","1","4","2","false","1967","2.0","2","2","false","0","1967","0"
"1.0","0.0","1.0","1.0","1","4","2","false","18996","2.0","2","2","false","0","18996","0"
"6.596343516959346","0.0","0.1515991393457569","1.0","12","30","15","false","832","15.066666666666666","15","15","false","0","832","0"
"6.596343516959346","0.0","0.1515991393457569","1.0","12","30","15","false","3387","15.066666666666666","15","15","false","0","3387","0"
"6.596343516959346","0.0","0.1515991393457569","1.0","12","30","15","false","4703","15.066666666666666","15","15","false","0","4703","0"
"6.596343516959346","0.0","0.1515991393457569","1.0","12","30","15","false","7447","15.066666666666666","15","15","false","0","7447","0"
"6.596343516959346","0.0","0.1515991393457569","1.0","12","30","15","false","9764","15.066666666666666","15","15","false","0","9764","0"
"6.596343516959346","0.0","0.1515991393457569","1.0","12","30","15","false","10117","15.066666666666666","15","15","false","0","10117","0"
"6.596343516959346","0.0","0.1515991393457569","1.0","12","30","15","false","14340","15.066666666666666","15","15","false","0","14340","0"
"6.596343516959346","0.0","0.1515991393457569","1.0","12","30","15","false","14370","15.066666666666666","15","15","false","0","14370","0"
"6.596343516959346","0.0","0.1515991393457569","1.0","12","30","15","false","15006","15.066666666666666","15","15","false","0","15006","0"
"6.596343516959346","0.0","0.1515991393457569","1.0","12","30","15","false","16231","15.066666666666666","15","15","false","0","16231","0"
"6.596343516959346","0.0","0.1515991393457569","1.0","12","30","15","false","16590","15.066666666666666","15","15","false","0","16590","0"
"6.596343516959346","0.0","0.1515991393457569","1.0","12","30","15","false","16730","15.066666666666666","15","15","false","0","16730","0"
"6.596343516959346","0.0","0.1515991393457569","1.0","12","30","15","false","19957","15.066666666666666","15","15","false","0","19957","0"
"6.596343516959346","0.0","0.1515991393457569","1.0","12","30","15","false","21848","15.066666666666666","15","15","false","0","21848","0"
"6.596343516959346","0.0","0.1515991393457569","1.0","12","30","15","false","22320","15.066666666666666","15","15","false","0","22320","0"
"1.0","0.0","1.0","0.0","1","2","1","false","15712","1.0","1","1","false","0","15712","0"
"1.0","0.0","1.0","0.0","1","2","1","false","19596","1.0","1","1","false","0","19596","0"
"5.876593697377917","0.0","0.17016660526423513","0.0","12","2","1","false","5365","12.0","1","1","false","0","5365","0"
"6.519605484724561","0.0","0.15338351413179838","1.0","12","4","2","false","7769","5.0","2","2","false","0","7769","0"
"6.519846042819341","0.0","0.1533778548500166","0.0","12","2","1","false","15977","8.0","1","1","false","0","15977","0"
"6.519605484724561","0.0","0.15338351413179838","1.0","12","4","2","false","17118","5.0","2","2","false","0","17118","0"
"1.0","0.0","1.0","1.0","1","6","3","false","1292","3.0","3","3","false","0","1292","0"
"1.0","0.0","1.0","1.0","1","8","4","false","6648","3.0","4","3","false","1","6648","0"
"1.0","0.0","1.0","1.0","1","6","3","false","10341","3.0","3","3","false","0","10341","0"
"1.0","0.0","1.0","1.0","1","8","4","false","14840","3.0","4","3","false","1","14840","0"
"2.4545454545454546","0.0","0.4074074074074074","0.0","4","2","1","false","16040","6.0","1","1","false","0","16040","0"
"1.0","2.6666666666666665","1.0","0.0","1","6","3","false","10936","1.0","3","3","false","0","10936","16"
"1.6666666666666667","0.0","0.6","0.0","2","2","1","false","19509","3.0","1","1","false","0","19509","0"
"1.6666666666666667","0.0","0.6","0.0","2","2","1","false","19510","3.0","1","1","false","0","19510","0"
"1.6666666666666667","0.0","0.6","0.0","2","2","1","false","23687","3.0","1","1","false","0","23687","0"
"1.0","0.0","1.0","1.0","1","6","3","false","17293","3.0","3","3","false","0","17293","0"
"1.0","0.0","1.0","1.0","1","6","3","false","15668","3.0","3","3","false","0","15668","0"
"1.0","0.0","1.0","1.0","1","6","3","false","25614","3.0","3","3","false","0","25614","0"
"1.0","0.0","1.0","1.0","1","6","3","false","26006","3.0","3","3","false","0","26006","0"
"6.266297810921338","0.0","0.1595838611846904","1.0","13","4","2","false","22394","3.0","2","2","false","0","22394","0"
"1.0","0.0","1.0","1.0","1","4","2","false","10178","2.0","2","2","false","0","10178","0"
"1.0","0.0","1.0","1.0","1","4","2","false","3744","2.0","2","2","false","0","3744","0"
"1.0","0.0","1.0","1.0","1","4","2","false","24133","2.0","2","2","false","0","24133","0"
"7.0442626894395","0.0","0.141959498685244","0.0","13","2","1","false","19256","6.0","1","1","false","0","19256","0"
"1.0","0.0","1.0","0.0","1","2","1","false","3989","1.0","1","1","false","0","3989","0"
"1.0","0.0","1.0","0.0","1","2","1","false","17471","1.0","1","1","false","0","17471","0"
"7.386576858311282","0.0","0.13538070735361166","1.0","13","4","2","false","510","5.5","2","2","false","0","510","0"
"7.386817416406062","0.0","0.13537629856384537","0.0","13","2","1","false","22285","7.0","1","1","false","0","22285","0"
"1.0","1.8333333333333333","1.0","0.3333333333333333","1","6","3","false","10679","1.6666666666666667","3","3","false","0","10679","11"
"1.3333333333333333","0.0","0.75","1.0","2","4","2","false","115","2.5","2","2","false","0","115","0"
"1.3333333333333333","0.0","0.75","1.0","2","4","2","false","5268","2.5","2","2","false","0","5268","0"
"1.6666666666666667","0.0","0.6","0.0","2","2","1","false","8671","3.0","1","1","false","0","8671","0"
"1.0","0.0","1.0","1.0","1","4","2","false","23757","2.0","2","2","false","0","23757","0"
"1.0","0.0","1.0","1.0","1","4","2","false","830","2.0","2","2","false","0","830","0"
"1.0","0.0","1.0","1.0","1","4","2","false","16802","2.0","2","2","false","0","16802","0"
"1.0","0.0","1.0","0.0","1","2","1","false","9053","1.0","1","1","false","0","9053","0"
"1.0","0.0","1.0","0.0","1","2","1","false","12504","1.0","1","1","false","0","12504","0"
"6.2352658166947315","0.0","0.1603780864197531","0.0","11","2","1","false","10850","5.0","1","1","false","0","10850","0"
"7.224440702429637","0.0","0.13841901971230688","0.0","13","2","1","false","12644","3.0","1","1","false","0","12644","0"
"7.224440702429637","0.0","0.13841901971230688","0.0","13","2","1","false","20528","3.0","1","1","false","0","20528","0"
"1.0","0.0","1.0","0.0","1","2","1","false","1589","1.0","1","1","false","0","1589","0"
"1.0","0.0","1.0","0.0","1","2","1","false","7603","1.0","1","1","false","0","7603","0"
"1.0","0.0","1.0","0.0","1","2","1","false","23759","1.0","1","1","false","0","23759","0"
"1.0","0.0","1.0","0.0","1","2","1","false","15208","1.0","1","1","false","0","15208","0"
"5.8636035602598024","0.0","0.17054358974358974","0.0","12","2","1","false","1561","10.0","1","1","false","0","1561","0"
"5.768583112821746","0.0","0.17335279399499584","1.0","12","4","2","false","4484","9.5","2","2","false","0","4484","0"
"5.823430358431561","0.0","0.17172009253139459","1.0","12","4","2","false","22379","7.0","2","2","false","0","22379","0"
"7.270868414722155","0.0","0.137535153019024","1.0","13","6","3","false","21558","4.333333333333333","3","3","false","0","21558","0"
"7.270868414722155","0.0","0.137535153019024","1.0","13","6","3","false","19683","4.333333333333333","3","3","false","0","19683","0"
"7.270868414722155","0.0","0.137535153019024","1.0","13","6","3","false","22744","4.333333333333333","3","3","false","0","22744","0"
"6.659850853981236","0.0","0.15015351273252664","1.0","12","4","2","false","22746","4.5","2","2","false","0","22746","0"
"1.0","2.333333333333333","1.0","0.5238095238095238","1","14","7","false","1981","4.142857142857143","7","7","false","0","1981","98"
"1.2857142857142858","0.0","0.7777777777777777","1.0","2","10","5","false","5468","5.4","5","5","false","0","5468","0"
"1.2857142857142858","0.0","0.7777777777777777","1.0","2","10","5","false","5668","5.4","5","5","false","0","5668","0"
"1.7142857142857142","0.0","0.5833333333333334","1.0","2","4","2","false","6908","4.5","2","2","false","0","6908","0"
"1.2857142857142858","0.0","0.7777777777777777","1.0","2","10","5","false","8187","5.4","5","5","false","0","8187","0"
"1.2857142857142858","0.0","0.7777777777777777","1.0","2","10","5","false","18034","5.4","5","5","false","0","18034","0"
"1.2857142857142858","0.0","0.7777777777777777","1.0","2","10","5","false","19879","5.4","5","5","false","0","19879","0"
"1.7142857142857142","0.0","0.5833333333333334","1.0","2","4","2","false","25444","4.5","2","2","false","0","25444","0"
"1.7142857142857142","0.0","0.5833333333333334","1.0","3","6","3","false","3818","4.0","3","3","false","0","3818","0"
"1.7142857142857142","0.0","0.5833333333333334","1.0","3","6","3","false","3388","4.0","3","3","false","0","3388","0"
"1.1428571428571428","2.6666666666666665","0.875","0.4","2","12","6","false","6735","3.3333333333333335","6","6","false","0","6735","149"
"1.7142857142857142","0.0","0.5833333333333334","1.0","3","6","3","false","23167","4.0","3","3","false","0","23167","0"
"6.376954534520086","0.0","0.15681466671696406","1.0","12","4","2","false","2806","4.5","2","2","false","0","2806","0"
"6.376954534520086","0.0","0.15681466671696406","1.0","12","4","2","false","9209","4.5","2","2","false","0","9209","0"
"6.969689680057734","0.0","0.14347841093431815","1.0","12","14","7","false","914","8.571428571428571","7","7","false","0","914","0"
"6.969689680057734","0.0","0.14347841093431815","1.0","12","14","7","false","2243","8.571428571428571","7","7","false","0","2243","0"
"6.969689680057734","0.0","0.14347841093431815","1.0","12","14","7","false","3442","8.571428571428571","7","7","false","0","3442","0"
"6.969689680057734","0.0","0.14347841093431815","1.0","12","14","7","false","5162","8.571428571428571","7","7","false","0","5162","0"
"6.969689680057734","0.0","0.14347841093431815","1.0","12","14","7","false","18633","8.571428571428571","7","7","false","0","18633","0"
"1.0","0.0","1.0","0.0","1","2","1","false","5119","1.0","1","1","false","0","5119","0"
"1.0","0.0","1.0","0.0","1","2","1","false","10517","1.0","1","1","false","0","10517","0"
"6.582631705556892","0.0","0.15191492471860837","0.0","11","2","1","false","13036","3.0","1","1","false","0","13036","0"
"1.0","0.0","1.0","0.0","1","2","1","false","6446","1.0","1","1","false","0","6446","0"
"1.0","0.0","1.0","0.0","1","2","1","false","8036","1.0","1","1","false","0","8036","0"
"6.56362761606928","0.0","0.15235477368517503","0.0","12","2","1","false","25114","4.0","1","1","false","0","25114","0"
"6.161414481597306","0.0","0.1623003943310038","0.0","12","2","1","false","21544","3.0","1","1","false","0","21544","0"
"1.0","2.333333333333333","1.0","0.0","1","8","4","false","13","1.0","4","3","false","1","13","14"
"1.6666666666666667","0.0","0.6","0.0","2","2","1","false","7596","3.0","1","1","false","0","7596","0"
"1.6666666666666667","0.0","0.6","0.0","2","2","1","false","11196","3.0","1","1","false","0","11196","0"
"1.6666666666666667","0.0","0.6","0.0","2","2","1","false","19170","3.0","1","1","false","0","19170","0"
"5.637478951166707","0.2582698463279279","0.17738425432046084","0.6","12","10","5","false","7090","6.6","5","5","false","0","7090","24448826"
"1.0","2.339285714285714","1.0","0.39285714285714285","1","16","8","false","6350","3.75","8","8","false","0","6350","155"
"1.875","0.0","0.5333333333333333","0.0","2","2","1","false","4495","8.0","1","1","false","0","4495","0"
"1.25","0.21428571428571425","0.8","0.7333333333333333","2","12","6","false","8372","5.0","6","6","false","0","8372","36"
"1.5","0.0","0.6666666666666666","1.0","2","8","4","false","11823","6.0","4","4","false","0","11823","0"
"1.25","0.21428571428571425","0.8","0.7333333333333333","2","12","6","false","13628","5.0","6","6","false","0","13628","36"
"1.5","0.0","0.6666666666666666","1.0","2","8","4","false","15246","6.0","4","4","false","0","15246","0"
"1.875","0.0","0.5333333333333333","0.0","2","2","1","false","16014","8.0","1","1","false","0","16014","0"
"1.5","0.0","0.6666666666666666","1.0","2","8","4","false","20332","6.0","4","4","false","0","20332","0"
"1.5","0.0","0.6666666666666666","1.0","2","8","4","false","23710","6.0","4","4","false","0","23710","0"
"1.0","0.0","1.0","0.0","1","2","1","false","5137","1.0","1","1","false","0","5137","0"
"1.0","0.0","1.0","0.0","1","2","1","false","6884","1.0","1","1","false","0","6884","0"
"1.5","0.0","0.6666666666666666","0.0","2","2","1","false","1013","2.0","1","1","false","0","1013","0"
"1.0","2.5","1.0","0.0","1","4","2","false","19011","1.0","2","2","false","0","19011","5"
"1.5","0.0","0.6666666666666666","0.0","2","2","1","false","2123","2.0","1","1","false","0","2123","0"
"7.076738032234784","0.0","0.14130804269494868","0.0","13","2","1","false","71","2.0","1","1","false","0","71","0"
"1.0","2.5","1.0","0.0","1","4","2","false","20803","1.0","2","2","false","0","20803","5"
"1.5","0.0","0.6666666666666666","0.0","2","2","1","false","6356","2.0","1","1","false","0","6356","0"
"1.5","0.0","0.6666666666666666","0.0","2","2","1","false","25231","2.0","1","1","false","0","25231","0"
"1.5","0.0","0.6666666666666666","0.0","2","2","1","false","1551","2.0","1","1","false","0","1551","0"
"1.0","2.5","1.0","0.0","1","4","2","false","8058","1.0","2","2","false","0","8058","5"
"1.5","0.0","0.6666666666666666","0.0","2","2","1","false","2328","2.0","1","1","false","0","2328","0"
"1.0","0.0","1.0","0.0","1","2","1","false","8336","1.0","1","1","false","0","8336","0"
"1.0","0.0","1.0","0.0","1","2","1","false","24464","1.0","1","1","false","0","24464","0"
"7.337262448881405","0.0","0.13629061342251073","0.0","14","2","1","false","12745","3.0","1","1","false","0","12745","0"
"7.487851816213616","0.0","0.1335496514280207","0.0","14","2","1","false","19023","4.0","1","1","false","0","19023","0"
"6.5973057493384655","0.0","0.15157702825888786","0.0","13","2","1","false","10468","5.0","1","1","false","0","10468","0"
"6.596102958864566","0.6315682026189112","0.15160466812545587","0.3333333333333333","13","6","3","false","8398","3.3333333333333335","3","3","false","0","8398","38707082"
"6.595862400769786","1.2610872623909992","0.15161019730843575","0.3333333333333333","13","8","4","false","9327","3.0","4","4","false","0","9327","77294274"
"1.3333333333333333","0.0","0.75","1.0","2","4","2","false","8739","2.5","2","2","false","0","8739","0"
"1.0","1.8333333333333333","1.0","0.3333333333333333","1","6","3","false","13357","1.6666666666666667","3","3","false","0","13357","11"
"1.3333333333333333","0.0","0.75","1.0","2","4","2","false","25115","2.5","2","2","false","0","25115","0"
"1.6666666666666667","0.0","0.6","0.0","2","2","1","false","25852","3.0","1","1","false","0","25852","0"
"6.049554967524657","0.0","0.16530141561953238","0.0","12","2","1","false","403","8.0","1","1","false","0","403","0"
"1.0","0.0","1.0","1.0","1","4","2","false","3200","2.0","2","2","false","0","3200","0"
"1.0","0.0","1.0","1.0","1","4","2","false","4264","2.0","2","2","false","0","4264","0"
"1.0","0.0","1.0","1.0","1","4","2","false","17468","2.0","2","2","false","0","17468","0"
"1.0","0.0","1.0","0.0","1","2","1","false","25510","1.0","1","1","false","0","25510","0"
"1.0","0.0","1.0","0.0","1","2","1","false","3279","1.0","1","1","false","0","3279","0"
"6.201828241520327","0.0","0.16124277568752182","1.0","12","4","2","false","1782","6.5","2","2","false","0","1782","0"
"6.732499398604763","0.0","0.14853324757923322","0.0","13","2","1","false","13521","7.0","1","1","false","0","13521","0"
"6.732499398604763","0.0","0.14853324757923322","0.0","13","2","1","false","18784","7.0","1","1","false","0","18784","0"
"5.996872744767861","0.9108015678182816","0.1667535801676762","0.0","12","4","2","false","8976","5.0","2","2","false","0","8976","63070993"
"6.031753668510945","0.0","0.16578926377921352","0.0","13","2","1","false","3910","7.0","1","1","false","0","3910","0"
"1.0","2.5","1.0","0.0","1","4","2","false","10513","1.0","2","2","false","0","10513","5"
"1.5","0.0","0.6666666666666666","0.0","2","2","1","false","25059","2.0","1","1","false","0","25059","0"
"1.5","0.0","0.6666666666666666","0.0","2","2","1","false","25595","2.0","1","1","false","0","25595","0"
"1.0","0.0","1.0","1.0","1","4","2","false","7477","2.0","2","2","false","0","7477","0"
"1.0","0.0","1.0","1.0","1","4","2","false","19257","2.0","2","2","false","0","19257","0"
"1.0","0.0","1.0","1.0","1","4","2","false","22961","2.0","2","2","false","0","22961","0"
"1.0","0.0","1.0","0.0","1","2","1","false","19906","1.0","1","1","false","0","19906","0"
"1.0","0.0","1.0","0.0","1","2","1","false","26102","1.0","1","1","false","0","26102","0"
"6.777964878518162","4.456839874770544","0.14753691084611018","0.16666666666666666","13","8","4","false","13749","2.5","4","4","false","0","13749","352675010"
"7.777483762328602","0.0","0.12857628901054716","1.0","14","4","2","false","12121","3.0","2","2","false","0","12121","0"
"7.777483762328602","0.0","0.12857628901054716","1.0","14","4","2","false","13034","3.0","2","2","false","0","13034","0"
"1.0","0.0","1.0","0.0","1","2","1","false","6079","1.0","1","1","false","0","6079","0"
"1.0","0.0","1.0","0.0","1","2","1","false","19941","1.0","1","1","false","0","19941","0"
"2.857142857142857","0.0","0.35","0.0","4","2","1","false","14135","2.0","1","1","false","0","14135","0"
"1.4285714285714286","0.6904761904761905","0.7","0.6666666666666666","2","8","4","false","13325","3.75","4","4","false","0","13325","58"
"1.4285714285714286","0.6904761904761905","0.7","0.6666666666666666","2","8","4","false","14502","3.75","4","4","false","0","14502","58"
"1.5714285714285714","0.0","0.6363636363636364","1.0","2","6","3","false","20926","4.666666666666667","3","3","false","0","20926","0"
"2.142857142857143","0.0","0.4666666666666667","1.0","3","4","2","false","15899","4.0","2","2","false","0","15899","0"
"1.0","0.0","1.0","0.0","1","2","1","false","16338","1.0","1","1","false","0","16338","0"
"1.0","0.0","1.0","0.0","1","2","1","false","21390","1.0","1","1","false","0","21390","0"
"1.0","0.0","1.0","0.0","1","2","1","false","82","1.0","1","1","false","0","82","0"
"1.0","0.0","1.0","0.0","1","2","1","false","3844","1.0","1","1","false","0","3844","0"
"7.744767861438538","0.0","0.12911942848268365","1.0","13","4","2","false","7595","3.5","2","2","false","0","7595","0"
"7.744767861438538","0.0","0.12911942848268365","1.0","13","4","2","false","8118","3.5","2","2","false","0","8118","0"
"7.745008419533317","0.0","0.12911541806435584","0.0","13","2","1","false","15802","5.0","1","1","false","0","15802","0"
"1.0","0.0","1.0","0.0","1","2","1","false","15688","1.0","1","1","false","0","15688","0"
"1.0","0.0","1.0","0.0","1","2","1","false","22692","1.0","1","1","false","0","22692","0"
"1.0","0.0","1.0","0.0","1","2","1","false","4955","1.0","1","1","false","0","4955","0"
"1.0","0.0","1.0","0.0","1","2","1","false","4954","1.0","1","1","false","0","4954","0"
"1.0","0.0","1.0","0.0","1","2","1","false","5409","1.0","1","1","false","0","5409","0"
"1.0","0.0","1.0","0.0","1","2","1","false","8623","1.0","1","1","false","0","8623","0"
"7.560259802742363","0.0","0.13227058673794068","0.0","13","2","1","false","11926","3.0","1","1","false","0","11926","0"
"5.798171758479673","0.2508799016364934","0.1724681574907688","0.4","12","10","5","false","8340","6.6","5","5","false","0","8340","34845371"
"1.0","0.0","1.0","1.0","1","4","2","false","5839","2.0","2","2","false","0","5839","0"
"1.0","0.0","1.0","1.0","1","4","2","false","7026","2.0","2","2","false","0","7026","0"
"1.0","0.0","1.0","1.0","1","4","2","false","12192","2.0","2","2","false","0","12192","0"
"6.19485205677171","0.0","0.16142435538987265","0.0","12","2","1","false","3053","2.0","1","1","false","0","3053","0"
"1.5","0.0","0.6666666666666666","0.0","2","2","1","false","20883","2.0","1","1","false","0","20883","0"
"1.0","2.5","1.0","0.0","1","4","2","false","787","1.0","2","2","false","0","787","5"
"1.5","0.0","0.6666666666666666","0.0","2","2","1","false","12940","2.0","1","1","false","0","12940","0"
"1.1666666666666667","1.0666666666666667","0.8571428571428571","0.5","2","10","5","false","2222","3.2","5","5","false","0","2222","54"
"1.5","0.0","0.6666666666666666","1.0","2","6","3","false","2215","4.666666666666667","3","3","false","0","2215","0"
"1.6666666666666667","0.0","0.6","1.0","2","4","2","false","10792","5.0","2","2","false","0","10792","0"
"1.1666666666666667","1.4333333333333333","0.8571428571428571","0.4","2","10","5","false","15695","3.0","5","5","false","0","15695","60"
"1.8333333333333333","0.0","0.5454545454545455","1.0","3","4","2","false","20422","4.5","2","2","false","0","20422","0"
"1.3333333333333333","0.4666666666666667","0.75","0.6666666666666666","2","8","4","false","21309","3.75","4","4","false","0","21309","28"
"2.0","0.0","0.5","0.0","3","2","1","false","20379","5.0","1","1","false","0","20379","0"
"2.0","0.6818181818181818","0.5","0.5","3","8","4","false","1549","3.25","4","4","false","0","1549","82"
"2.090909090909091","0.0","0.4782608695652174","1.0","3","6","3","false","22766","4.333333333333333","3","3","false","0","22766","0"
"2.090909090909091","0.0","0.4782608695652174","1.0","3","6","3","false","23168","4.333333333333333","3","3","false","0","23168","0"
"2.909090909090909","0.0","0.34375","0.0","4","2","1","false","24732","4.0","1","1","false","0","24732","0"
"1.0","0.0","1.0","0.0","1","2","1","false","4272","1.0","1","1","false","0","4272","0"
"1.0","0.0","1.0","0.0","1","2","1","false","2557","1.0","1","1","false","0","2557","0"
"1.8333333333333333","0.0","0.5454545454545455","0.0","2","2","1","false","2247","6.0","1","1","false","0","2247","0"
"1.0","3.0","1.0","0.26666666666666666","1","12","6","false","9606","2.3333333333333335","6","6","false","0","9606","90"
"1.5","0.0","0.6666666666666666","1.0","2","6","3","false","4958","4.0","3","3","false","0","4958","0"
"1.6666666666666667","0.0","0.6","1.0","2","4","2","false","5973","4.0","2","2","false","0","5973","0"
"1.5","0.0","0.6666666666666666","1.0","2","6","3","false","10884","4.0","3","3","false","0","10884","0"
"1.6666666666666667","0.0","0.6","1.0","2","4","2","false","12122","4.0","2","2","false","0","12122","0"
"1.5","0.0","0.6666666666666666","1.0","2","6","3","false","16353","4.0","3","3","false","0","16353","0"
"6.6242482559538125","1.3150995005236017","0.1509605258379635","0.0","12","4","2","false","1427","2.5","2","2","false","0","1427","108002535"
"7.6240076978590325","0.0","0.13116461048180986","0.0","13","2","1","false","11037","2.0","1","1","false","0","11037","0"
"1.0","0.0","1.0","0.0","1","2","1","false","2981","1.0","1","1","false","0","2981","0"
"1.0","0.0","1.0","0.0","1","2","1","false","4427","1.0","1","1","false","0","4427","0"
"1.0","0.0","1.0","0.0","1","2","1","false","6669","1.0","1","1","false","0","6669","0"
"1.0","0.0","1.0","0.0","1","2","1","false","9865","1.0","1","1","false","0","9865","0"
"7.316333894635554","0.0","0.1366804760965345","1.0","12","6","3","false","8449","5.0","3","3","false","0","8449","0"
"7.316333894635554","0.0","0.1366804760965345","1.0","12","6","3","false","13490","5.0","3","3","false","0","13490","0"
"7.316333894635554","0.0","0.1366804760965345","1.0","12","6","3","false","19528","5.0","3","3","false","0","19528","0"
"7.316574452730334","0.0","0.1366759822456025","1.0","12","4","2","false","22577","5.5","2","2","false","0","22577","0"
"7.316574452730334","0.0","0.1366759822456025","1.0","12","4","2","false","25440","5.5","2","2","false","0","25440","0"
"9.339186913639644","0.0","0.10707570254745899","0.0","14","2","1","false","18366","4.0","1","1","false","0","18366","0"
"9.339186913639644","0.0","0.10707570254745899","0.0","14","2","1","false","25217","4.0","1","1","false","0","25217","0"
"6.662496993023815","0.0","0.15009387637203928","1.0","13","4","2","false","4750","3.5","2","2","false","0","4750","0"
"6.662496993023815","0.0","0.15009387637203928","1.0","13","4","2","false","19147","3.5","2","2","false","0","19147","0"
"6.551840269425067","0.0","0.1526288735497136","0.0","12","2","1","false","20174","2.0","1","1","false","0","20174","0"
"1.0","0.0","1.0","0.0","1","2","1","false","7588","1.0","1","1","false","0","7588","0"
"1.0","0.0","1.0","0.0","1","2","1","false","7590","1.0","1","1","false","0","7590","0"
"1.0","0.0","1.0","0.0","1","2","1","false","3599","1.0","1","1","false","0","3599","0"
"1.0","0.0","1.0","0.0","1","2","1","false","14130","1.0","1","1","false","0","14130","0"
"1.0","2.0","1.0","0.0","1","4","2","false","14302","1.0","2","2","false","0","14302","4"
"1.5","0.0","0.6666666666666666","0.0","2","2","1","false","5432","2.0","1","1","false","0","5432","0"
"1.5","0.0","0.6666666666666666","0.0","2","2","1","false","12676","2.0","1","1","false","0","12676","0"
"1.8571428571428572","0.0","0.5384615384615384","1.0","3","6","3","false","11721","3.6666666666666665","3","3","false","0","11721","0"
"1.8571428571428572","0.0","0.5384615384615384","1.0","3","6","3","false","12151","3.6666666666666665","3","3","false","0","12151","0"
"1.8571428571428572","0.0","0.5384615384615384","1.0","3","6","3","false","15221","3.6666666666666665","3","3","false","0","15221","0"
"5.962954053403897","0.0","0.16770211392609327","1.0","12","6","3","false","11792","5.666666666666667","3","3","false","0","11792","0"
"5.962954053403897","0.0","0.16770211392609327","1.0","12","6","3","false","16831","5.666666666666667","3","3","false","0","16831","0"
"1.5","0.8333333333333334","0.6666666666666666","0.6666666666666666","2","6","3","false","5667","3.3333333333333335","3","3","false","0","5667","50"
"1.8333333333333333","1.8333333333333333","0.5454545454545455","0.3333333333333333","3","6","3","false","3297","2.3333333333333335","3","3","false","0","3297","89"
"1.5","1.9333333333333333","0.6666666666666666","0.3333333333333333","3","8","4","false","14770","2.5","4","4","false","0","14770","88"
"1.5","0.8333333333333334","0.6666666666666666","0.6666666666666666","2","6","3","false","23461","3.3333333333333335","3","3","false","0","23461","50"
"2.0","0.0","0.5","1.0","3","4","2","false","2329","3.0","2","2","false","0","2329","0"
"2.0","0.0","0.5","1.0","3","4","2","false","24846","3.0","2","2","false","0","24846","0"
"6.9959105123887415","0.0","0.14294065057423838","0.0","13","2","1","false","8367","4.0","1","1","false","0","8367","0"
"1.0","2.0","1.0","0.0","1","4","2","false","14894","1.0","2","2","false","0","14894","4"
"1.5","0.0","0.6666666666666666","0.0","2","2","1","false","1670","2.0","1","1","false","0","1670","0"
"1.5","0.0","0.6666666666666666","0.0","2","2","1","false","22927","2.0","1","1","false","0","22927","0"
"1.0","2.5","1.0","0.0","1","4","2","false","3362","1.0","2","2","false","0","3362","5"
"1.5","0.0","0.6666666666666666","0.0","2","2","1","false","3347","2.0","1","1","false","0","3347","0"
"1.5","0.0","0.6666666666666666","0.0","2","2","1","false","16957","2.0","1","1","false","0","16957","0"
"8.700024055809479","0.0","0.11494221091633025","0.0","15","2","1","false","8969","3.0","1","1","false","0","8969","0"
"7.965600192446476","0.0","0.1255398181982907","1.0","13","4","2","false","25649","3.0","2","2","false","0","25649","0"
"7.965600192446476","0.0","0.1255398181982907","1.0","13","4","2","false","25839","3.0","2","2","false","0","25839","0"
"1.0","0.0","1.0","0.0","1","2","1","false","2938","1.0","1","1","false","0","2938","0"
"1.0","0.0","1.0","0.0","1","2","1","false","18581","1.0","1","1","false","0","18581","0"
"8.19533317296127","0.0","0.12202066455324645","1.0","15","4","2","false","1024","3.5","2","2","false","0","1024","0"
"8.19533317296127","0.0","0.12202066455324645","1.0","15","4","2","false","12552","3.5","2","2","false","0","12552","0"
"8.19557373105605","0.0","0.12201708297866094","0.0","15","2","1","false","16513","5.0","1","1","false","0","16513","0"
"1.0","0.0","1.0","0.0","1","2","1","false","21593","1.0","1","1","false","0","21593","0"
"1.0","0.0","1.0","0.0","1","2","1","false","22325","1.0","1","1","false","0","22325","0"
"1.0","0.0","1.0","1.0","1","8","4","false","18970","4.0","4","4","false","0","18970","0"
"1.0","0.0","1.0","1.0","1","8","4","false","2409","4.0","4","4","false","0","2409","0"
"1.0","0.0","1.0","1.0","1","8","4","false","3522","4.0","4","4","false","0","3522","0"
"1.0","0.0","1.0","1.0","1","8","4","false","4286","4.0","4","4","false","0","4286","0"
"1.0","0.0","1.0","1.0","1","8","4","false","4288","4.0","4","4","false","0","4288","0"
"6.685109453933125","0.0","0.14958618207988486","0.0","13","2","1","false","18278","3.0","1","1","false","0","18278","0"
"1.0","0.0","1.0","1.0","1","4","2","false","2201","2.0","2","2","false","0","2201","0"
"1.0","0.0","1.0","1.0","1","4","2","false","14868","2.0","2","2","false","0","14868","0"
"1.0","0.0","1.0","1.0","1","4","2","false","16226","2.0","2","2","false","0","16226","0"
"1.0","0.0","1.0","1.0","1","6","3","false","5211","3.0","3","3","false","0","5211","0"
"1.0","0.0","1.0","1.0","1","6","3","false","11028","3.0","3","3","false","0","11028","0"
"1.0","0.0","1.0","1.0","1","6","3","false","21171","3.0","3","3","false","0","21171","0"
"1.0","0.0","1.0","1.0","1","6","3","false","22730","3.0","3","3","false","0","22730","0"
"1.0","0.0","1.0","0.0","1","2","1","false","1187","1.0","1","1","false","0","1187","0"
"1.0","0.0","1.0","0.0","1","2","1","false","6290","1.0","1","1","false","0","6290","0"
"6.036083714216983","0.039010969031662436","0.16567033317392","0.6666666666666666","12","8","4","false","8161","5.75","4","4","false","0","8161","4025698"
"6.171036805388502","0.0","0.1620473238997388","1.0","13","4","2","false","12054","7.0","2","2","false","0","12054","0"
"6.170796247293722","0.0","0.16205364104163417","1.0","13","6","3","false","21468","7.333333333333333","3","3","false","0","21468","0"
"1.0","0.0","1.0","1.0","1","4","2","false","13677","2.0","2","2","false","0","13677","0"
"1.0","0.0","1.0","1.0","1","4","2","false","18288","2.0","2","2","false","0","18288","0"
"1.0","0.0","1.0","1.0","1","4","2","false","23206","2.0","2","2","false","0","23206","0"
"1.0","2.0","1.0","0.0","1","4","2","false","4110","1.0","2","2","false","0","4110","4"
"1.5","0.0","0.6666666666666666","0.0","2","2","1","false","16523","2.0","1","1","false","0","16523","0"
"1.5","0.0","0.6666666666666666","0.0","2","2","1","false","17696","2.0","1","1","false","0","17696","0"
"1.0","1.5","1.0","0.3333333333333333","1","6","3","false","15641","1.6666666666666667","3","3","false","0","15641","9"
"1.6666666666666667","0.0","0.6","0.0","2","2","1","false","5466","3.0","1","1","false","0","5466","0"
"1.3333333333333333","0.0","0.75","1.0","2","4","2","false","12801","2.5","2","2","false","0","12801","0"
"1.3333333333333333","0.0","0.75","1.0","2","4","2","false","19548","2.5","2","2","false","0","19548","0"
"5.728650469088285","0.0","0.17456118249769043","0.0","11","2","1","false","10352","4.0","1","1","false","0","10352","0"
"1.0","0.0","1.0","0.0","1","2","1","false","15423","1.0","1","1","false","0","15423","0"
"1.0","0.0","1.0","0.0","1","2","1","false","18144","1.0","1","1","false","0","18144","0"
"6.555689198941544","0.0","0.15253926317334507","0.0","12","2","1","false","4959","29.0","1","1","false","0","4959","0"
"6.555448640846764","0.0","0.15254486073905546","1.0","12","4","2","false","6867","26.5","2","2","false","0","6867","0"
"6.19485205677171","0.0","0.16142435538987265","0.0","12","2","1","false","19110","2.0","1","1","false","0","19110","0"
"1.0","0.0","1.0","1.0","1","4","2","false","9149","2.0","2","2","false","0","9149","0"
"1.0","0.0","1.0","1.0","1","4","2","false","17346","2.0","2","2","false","0","17346","0"
"1.0","0.0","1.0","1.0","1","4","2","false","20319","2.0","2","2","false","0","20319","0"
"6.8888621602116915","0.0","0.14516185354611166","1.0","13","4","2","false","16042","4.0","2","2","false","0","16042","0"
"6.524657204714939","0.0","0.15326475684843122","1.0","12","4","2","false","5533","4.5","2","2","false","0","5533","0"
"1.25","0.0","0.8","1.0","2","6","3","false","782","3.3333333333333335","3","3","false","0","782","0"
"1.25","0.0","0.8","1.0","2","6","3","false","11539","3.3333333333333335","3","3","false","0","11539","0"
"1.0","1.0","1.0","0.5","1","8","4","false","15227","2.5","4","4","false","0","15227","12"
"1.25","0.0","0.8","1.0","2","6","3","false","16655","3.3333333333333335","3","3","false","0","16655","0"
"1.75","0.0","0.5714285714285714","0.0","2","2","1","false","18151","4.0","1","1","false","0","18151","0"
"7.559297570363243","1.4974200202216976","0.13228742362525459","0.0","13","4","2","false","21811","2.5","2","2","false","0","21811","102422707"
"1.0","0.0","1.0","0.0","1","2","1","false","254","1.0","1","1","false","0","254","0"
"1.0","0.0","1.0","0.0","1","2","1","false","7572","1.0","1","1","false","0","7572","0"
"1.0","0.0","1.0","1.0","1","4","2","false","20150","2.0","2","2","false","0","20150","0"
"1.0","0.0","1.0","1.0","1","4","2","false","22312","2.0","2","2","false","0","22312","0"
"1.0","0.0","1.0","1.0","1","4","2","false","25226","2.0","2","2","false","0","25226","0"
"1.0","0.0","1.0","0.0","1","2","1","false","23621","1.0","1","1","false","0","23621","0"
"1.0","0.0","1.0","0.0","1","2","1","false","11623","1.0","1","1","false","0","11623","0"
"6.733942747173442","9.140930577804799","0.14850141106705247","0.3333333333333333","13","8","4","false","23306","4.5","4","4","false","0","23306","1839857418"
"1.0","0.0","1.0","1.0","1","8","4","false","5960","4.0","4","4","false","0","5960","0"
"1.0","0.0","1.0","1.0","1","8","4","false","8705","4.0","4","4","false","0","8705","0"
"1.0","0.0","1.0","1.0","1","8","4","false","11662","4.0","4","4","false","0","11662","0"
"1.0","0.0","1.0","1.0","1","8","4","false","14094","4.0","4","4","false","0","14094","0"
"1.0","0.0","1.0","1.0","1","8","4","false","19014","4.0","4","4","false","0","19014","0"
"1.0","2.5","1.0","0.0","1","4","2","false","24575","1.0","2","2","false","0","24575","5"
"1.5","0.0","0.6666666666666666","0.0","2","2","1","false","8255","2.0","1","1","false","0","8255","0"
"1.5","0.0","0.6666666666666666","0.0","2","2","1","false","14842","2.0","1","1","false","0","14842","0"
"6.067356266538369","0.0","0.16481643010070574","1.0","12","22","11","false","3719","16.363636363636363","11","11","false","0","3719","0"
"6.0661534760644695","0.003049009055516341","0.16484910972756475","0.75","12","32","16","false","5067","14.0625","16","16","false","0","5067","377100"
"6.0661534760644695","0.003049009055516341","0.16484910972756475","0.75","12","32","16","false","6907","14.0625","16","16","false","0","6907","377100"
"6.067356266538369","0.0","0.16481643010070574","1.0","12","22","11","false","8072","16.363636363636363","11","11","false","0","8072","0"
"6.067356266538369","0.0","0.16481643010070574","1.0","12","22","11","false","8375","16.363636363636363","11","11","false","0","8375","0"
"6.0661534760644695","0.003049009055516341","0.16484910972756475","0.75","12","32","16","false","9025","14.0625","16","16","false","0","9025","377100"
"6.0661534760644695","0.003049009055516341","0.16484910972756475","0.75","12","32","16","false","13649","14.0625","16","16","false","0","13649","377100"
"6.067356266538369","0.0","0.16481643010070574","1.0","12","22","11","false","19545","16.363636363636363","11","11","false","0","19545","0"
"6.067356266538369","0.0","0.16481643010070574","1.0","12","22","11","false","25060","16.363636363636363","11","11","false","0","25060","0"
"6.0661534760644695","0.003049009055516341","0.16484910972756475","0.75","12","32","16","false","25289","14.0625","16","16","false","0","25289","377100"
"6.070483521770508","0.0","0.16473152367743213","1.0","12","20","10","false","15683","14.5","10","10","false","0","15683","0"
"6.070483521770508","0.0","0.16473152367743213","1.0","12","20","10","false","19923","14.5","10","10","false","0","19923","0"
"6.070483521770508","0.0","0.16473152367743213","1.0","12","20","10","false","20664","14.5","10","10","false","0","20664","0"
"6.070483521770508","0.0","0.16473152367743213","1.0","12","20","10","false","21824","14.5","10","10","false","0","21824","0"
"6.070483521770508","0.0","0.16473152367743213","1.0","12","20","10","false","25359","14.5","10","10","false","0","25359","0"
"1.0","0.0","1.0","1.0","1","8","4","false","1989","4.0","4","4","false","0","1989","0"
"1.0","0.0","1.0","1.0","1","8","4","false","4106","4.0","4","4","false","0","4106","0"
"1.0","0.0","1.0","1.0","1","8","4","false","7515","4.0","4","4","false","0","7515","0"
"1.0","0.0","1.0","1.0","1","8","4","false","17782","4.0","4","4","false","0","17782","0"
"1.0","0.0","1.0","1.0","1","8","4","false","18231","4.0","4","4","false","0","18231","0"
"1.6666666666666667","0.0","0.6","0.0","2","2","1","false","18628","3.0","1","1","false","0","18628","0"
"1.0","1.8333333333333333","1.0","0.3333333333333333","1","6","3","false","17785","1.6666666666666667","3","3","false","0","17785","11"
"1.3333333333333333","0.0","0.75","1.0","2","4","2","false","15583","2.5","2","2","false","0","15583","0"
"1.3333333333333333","0.0","0.75","1.0","2","4","2","false","24272","2.5","2","2","false","0","24272","0"
"6.272311763290835","0.0","0.1594308506558257","1.0","13","6","3","false","18091","5.666666666666667","3","3","false","0","18091","0"
"6.272311763290835","0.0","0.1594308506558257","1.0","13","6","3","false","24456","5.666666666666667","3","3","false","0","24456","0"
"1.0","0.0","1.0","0.0","1","2","1","false","25211","1.0","1","1","false","0","25211","0"
"1.0","0.0","1.0","0.0","1","2","1","false","11971","1.0","1","1","false","0","11971","0"
"8.472937214337263","0.0","0.11802282664243938","1.0","14","4","2","false","938","2.5","2","2","false","0","938","0"
"8.472937214337263","0.0","0.11802282664243938","1.0","14","4","2","false","5087","2.5","2","2","false","0","5087","0"
"2.6666666666666665","0.0","0.375","0.0","4","2","1","false","17936","3.0","1","1","false","0","17936","0"
"1.0","0.0","1.0","0.0","1","2","1","false","7636","1.0","1","1","false","0","7636","0"
"1.0","0.0","1.0","0.0","1","2","1","false","12554","1.0","1","1","false","0","12554","0"
"1.0","0.0","1.0","0.0","1","2","1","false","4278","1.0","1","1","false","0","4278","0"
"1.0","0.0","1.0","0.0","1","2","1","false","18183","1.0","1","1","false","0","18183","0"
"1.0","0.0","1.0","0.0","1","2","1","false","10522","1.0","1","1","false","0","10522","0"
"1.0","0.0","1.0","0.0","1","2","1","false","10561","1.0","1","1","false","0","10561","0"
"1.2","0.0","0.8333333333333334","1.0","2","8","4","false","25678","4.25","4","4","false","0","25678","0"
"1.2","0.0","0.8333333333333334","1.0","2","8","4","false","1660","4.25","4","4","false","0","1660","0"
"1.0","1.2000000000000002","1.0","0.6","1","10","5","false","3377","3.4","5","5","false","0","3377","24"
"1.2","0.0","0.8333333333333334","1.0","2","8","4","false","23068","4.25","4","4","false","0","23068","0"
"1.2","0.0","0.8333333333333334","1.0","2","8","4","false","25631","4.25","4","4","false","0","25631","0"
"1.8","0.0","0.5555555555555556","0.0","2","2","1","false","1383","5.0","1","1","false","0","1383","0"
"7.638441183545826","0.0","0.1309167637703524","1.0","13","4","2","false","6737","3.0","2","2","false","0","6737","0"
"7.229492422420014","0.0","0.1383222972748145","1.0","13","4","2","false","9988","3.0","2","2","false","0","9988","0"
"7.229492422420014","0.0","0.1383222972748145","1.0","13","4","2","false","14620","3.0","2","2","false","0","14620","0"
"1.0","0.0","1.0","1.0","1","4","2","false","822","2.0","2","2","false","0","822","0"
"1.0","0.0","1.0","1.0","1","4","2","false","9518","2.0","2","2","false","0","9518","0"
"1.0","0.0","1.0","1.0","1","4","2","false","16358","2.0","2","2","false","0","16358","0"
"1.25","0.0","0.8","1.0","2","6","3","false","18238","3.3333333333333335","3","3","false","0","18238","0"
"1.0","1.9166666666666665","1.0","0.5","1","8","4","false","4777","2.5","4","4","false","0","4777","23"
"1.25","0.0","0.8","1.0","2","6","3","false","15396","3.3333333333333335","3","3","false","0","15396","0"
"1.25","0.0","0.8","1.0","2","6","3","false","26180","3.3333333333333335","3","3","false","0","26180","0"
"1.75","0.0","0.5714285714285714","0.0","2","2","1","false","19064","4.0","1","1","false","0","19064","0"
"1.0","0.0","1.0","1.0","1","6","3","false","360","3.0","3","3","false","0","360","0"
"1.0","0.0","1.0","1.0","1","6","3","false","2304","3.0","3","3","false","0","2304","0"
"1.0","0.0","1.0","1.0","1","6","3","false","7602","3.0","3","3","false","0","7602","0"
"1.0","0.0","1.0","1.0","1","6","3","false","8307","3.0","3","3","false","0","8307","0"
"8.945633870579744","0.0","0.11178637695969022","0.0","15","2","1","false","9514","6.0","1","1","false","0","9514","0"
"8.945393312484965","0.0","0.11178938310116711","1.0","15","4","2","false","1959","4.0","2","2","false","0","1959","0"
"8.945393312484965","0.0","0.11178938310116711","1.0","15","4","2","false","9723","4.0","2","2","false","0","9723","0"
"2.1666666666666665","0.0","0.46153846153846156","1.0","4","4","2","false","21713","3.0","2","2","false","0","21713","0"
"2.1666666666666665","0.0","0.46153846153846156","1.0","4","4","2","false","25470","3.0","2","2","false","0","25470","0"
"1.0","0.0","1.0","1.0","1","4","2","false","5446","2.0","2","2","false","0","5446","0"
"1.0","0.0","1.0","1.0","1","4","2","false","5632","2.0","2","2","false","0","5632","0"
"1.0","0.0","1.0","1.0","1","4","2","false","20433","2.0","2","2","false","0","20433","0"
"6.8270387298532595","0.0","0.14647639182522904","0.0","13","2","1","false","18558","5.0","1","1","false","0","18558","0"
"1.0","0.0","1.0","1.0","1","4","2","false","10818","2.0","2","2","false","0","10818","0"
"1.0","0.0","1.0","1.0","1","4","2","false","11016","2.0","2","2","false","0","11016","0"
"1.0","0.0","1.0","1.0","1","4","2","false","25596","2.0","2","2","false","0","25596","0"
"6.681019966321867","0.0","0.1496777445720664","1.0","12","4","2","false","6513","3.0","2","2","false","0","6513","0"
"6.681019966321867","0.0","0.1496777445720664","1.0","12","4","2","false","25138","3.0","2","2","false","0","25138","0"
"6.681260524416647","0.0","0.14967235544033988","0.0","12","2","1","false","17275","4.0","1","1","false","0","17275","0"
"6.939860476305028","0.0","0.14409511594855973","0.0","13","2","1","false","16801","5.0","1","1","false","0","16801","0"
"1.6","0.0","0.625","1.0","2","4","2","false","19451","3.5","2","2","false","0","19451","0"
"1.0","2.75","1.0","0.1","1","10","5","false","9579","1.4","5","5","false","0","9579","55"
"1.6","0.0","0.625","1.0","2","4","2","false","16932","3.5","2","2","false","0","16932","0"
"1.8","0.0","0.5555555555555556","0.0","2","2","1","false","6534","5.0","1","1","false","0","6534","0"
"1.8","0.0","0.5555555555555556","0.0","2","2","1","false","11561","5.0","1","1","false","0","11561","0"
"1.8","0.0","0.5555555555555556","0.0","2","2","1","false","22381","5.0","1","1","false","0","22381","0"
"1.0","0.0","1.0","0.0","1","2","1","false","12863","1.0","1","1","false","0","12863","0"
"1.0","0.0","1.0","0.0","1","2","1","false","18390","1.0","1","1","false","0","18390","0"
"1.0","0.0","1.0","0.0","1","2","1","false","1836","1.0","1","1","false","0","1836","0"
"1.0","0.0","1.0","0.0","1","2","1","false","8400","1.0","1","1","false","0","8400","0"
"7.297089247053163","0.0","0.1370409441550735","1.0","13","4","2","false","13387","3.5","2","2","false","0","13387","0"
"7.297089247053163","0.0","0.1370409441550735","1.0","13","4","2","false","22048","3.5","2","2","false","0","22048","0"
"1.0","0.0","1.0","1.0","1","8","4","false","23424","4.0","4","4","false","0","23424","0"
"1.0","0.0","1.0","1.0","1","8","4","false","8153","4.0","4","4","false","0","8153","0"
"1.0","0.0","1.0","1.0","1","8","4","false","15182","4.0","4","4","false","0","15182","0"
"1.0","0.0","1.0","1.0","1","8","4","false","16728","4.0","4","4","false","0","16728","0"
"1.0","0.0","1.0","1.0","1","8","4","false","22319","4.0","4","4","false","0","22319","0"
"1.0","0.0","1.0","0.0","1","2","1","false","8054","1.0","1","1","false","0","8054","0"
"1.0","0.0","1.0","0.0","1","2","1","false","24504","1.0","1","1","false","0","24504","0"
"1.0","0.0","1.0","0.0","1","2","1","false","22605","1.0","1","1","false","0","22605","0"
"1.0","0.0","1.0","0.0","1","2","1","false","21623","1.0","1","1","false","0","21623","0"
"1.0","1.3","1.0","0.6","1","10","5","false","7479","3.4","5","5","false","0","7479","26"
"1.2","0.0","0.8333333333333334","1.0","2","8","4","false","2754","4.25","4","4","false","0","2754","0"
"1.2","0.0","0.8333333333333334","1.0","2","8","4","false","5511","4.25","4","4","false","0","5511","0"
"1.2","0.0","0.8333333333333334","1.0","2","8","4","false","7265","4.25","4","4","false","0","7265","0"
"1.2","0.0","0.8333333333333334","1.0","2","8","4","false","10056","4.25","4","4","false","0","10056","0"
"1.8","0.0","0.5555555555555556","0.0","2","2","1","false","13390","5.0","1","1","false","0","13390","0"
"6.996632186673081","0.0","0.14292590682482378","0.0","13","2","1","false","25176","2.0","1","1","false","0","25176","0"
"1.0","0.0","1.0","0.0","1","2","1","false","10382","1.0","1","1","false","0","10382","0"
"1.0","0.0","1.0","0.0","1","2","1","false","25482","1.0","1","1","false","0","25482","0"
"1.0","0.0","1.0","1.0","1","4","2","false","2223","2.0","2","2","false","0","2223","0"
"1.0","0.0","1.0","1.0","1","4","2","false","4266","2.0","2","2","false","0","4266","0"
"1.0","0.0","1.0","1.0","1","4","2","false","20216","2.0","2","2","false","0","20216","0"
"1.0","0.0","1.0","0.0","1","2","1","false","16643","1.0","1","1","false","0","16643","0"
"1.0","0.0","1.0","0.0","1","2","1","false","20035","1.0","1","1","false","0","20035","0"
"1.0","2.0","1.0","0.0","1","4","2","false","6170","1.0","2","2","false","0","6170","4"
"1.5","0.0","0.6666666666666666","0.0","2","2","1","false","8881","2.0","1","1","false","0","8881","0"
"1.5","0.0","0.6666666666666666","0.0","2","2","1","false","16609","2.0","1","1","false","0","16609","0"
"1.0","0.0","1.0","0.0","1","2","1","false","372","1.0","1","1","false","0","372","0"
"1.0","0.0","1.0","0.0","1","2","1","false","14131","1.0","1","1","false","0","14131","0"
"1.6666666666666667","0.0","0.6","0.0","2","2","1","false","12113","3.0","1","1","false","0","12113","0"
"1.0","1.8333333333333333","1.0","0.3333333333333333","1","6","3","false","16886","1.6666666666666667","3","3","false","0","16886","11"
"1.3333333333333333","0.0","0.75","1.0","2","4","2","false","142","2.5","2","2","false","0","142","0"
"1.3333333333333333","0.0","0.75","1.0","2","4","2","false","18626","2.5","2","2","false","0","18626","0"
"1.0","0.0","1.0","0.0","1","2","1","false","8735","1.0","1","1","false","0","8735","0"
"1.0","0.0","1.0","0.0","1","2","1","false","25062","1.0","1","1","false","0","25062","0"
"6.802020687996151","0.0","0.1470151365115292","1.0","13","4","2","false","1793","5.5","2","2","false","0","1793","0"
"6.802020687996151","0.0","0.1470151365115292","1.0","13","4","2","false","5481","5.5","2","2","false","0","5481","0"
"8.770988693769546","1.7928383262065006","0.11401223224815556","0.3333333333333333","15","6","3","false","3754","2.0","3","3","false","0","3754","176211282"
"9.770507577579986","0.0","0.10234882804805988","1.0","16","4","2","false","8185","2.5","2","2","false","0","8185","0"
"9.770507577579986","0.0","0.10234882804805988","1.0","16","4","2","false","16496","2.5","2","2","false","0","16496","0"
"1.0","0.0","1.0","0.0","1","2","1","false","9039","1.0","1","1","false","0","9039","0"
"1.0","0.0","1.0","0.0","1","2","1","false","11911","1.0","1","1","false","0","11911","0"
"6.462593216261727","0.0","0.15473664619393263","1.0","12","8","4","false","18613","7.5","4","4","false","0","18613","0"
"7.488573490497955","0.0","0.13353678123996146","0.0","13","2","1","false","10497","3.0","1","1","false","0","10497","0"
"6.262929997594419","0.0","0.15966967543691185","1.0","12","8","4","false","357","5.75","4","4","false","0","357","0"
"6.262929997594419","0.0","0.15966967543691185","1.0","12","8","4","false","23300","5.75","4","4","false","0","23300","0"
"6.262929997594419","0.0","0.15966967543691185","1.0","12","8","4","false","24960","5.75","4","4","false","0","24960","0"
"1.0","0.0","1.0","0.0","1","2","1","false","21303","1.0","1","1","false","0","21303","0"
"1.0","0.0","1.0","0.0","1","2","1","false","734","1.0","1","1","false","0","734","0"
"1.0","0.0","1.0","0.0","1","2","1","false","19221","1.0","1","1","false","0","19221","0"
"1.0","0.0","1.0","0.0","1","2","1","false","17470","1.0","1","1","false","0","17470","0"
"6.905220110656724","0.0","0.1448179759623759","0.0","13","2","1","false","18772","3.0","1","1","false","0","18772","0"
"1.0","0.0","1.0","0.0","1","2","1","false","21949","1.0","1","1","false","0","21949","0"
"1.0","0.0","1.0","0.0","1","2","1","false","18194","1.0","1","1","false","0","18194","0"
"1.0","0.0","1.0","0.0","1","2","1","false","5697","1.0","1","1","false","0","5697","0"
"1.0","0.0","1.0","0.0","1","2","1","false","14358","1.0","1","1","false","0","14358","0"
"1.0","0.0","1.0","0.0","1","2","1","false","8558","1.0","1","1","false","0","8558","0"
"1.0","0.0","1.0","0.0","1","2","1","false","13717","1.0","1","1","false","0","13717","0"
"1.0","0.0","1.0","0.0","1","2","1","false","8534","1.0","1","1","false","0","8534","0"
"1.0","0.0","1.0","0.0","1","2","1","false","8676","1.0","1","1","false","0","8676","0"
"7.297329805147943","0.0","0.13703642656996867","0.0","13","2","1","false","14639","5.0","1","1","false","0","14639","0"
"8.213134471974982","0.0","0.12175619471618535","1.0","14","6","3","false","2073","4.666666666666667","3","3","false","0","2073","0"
"8.730093817656964","0.0","0.11454630624672783","1.0","15","4","2","false","1662","3.5","2","2","false","0","1662","0"
"8.730093817656964","0.0","0.11454630624672783","1.0","15","4","2","false","2613","3.5","2","2","false","0","2613","0"
"1.0","0.41666666666666663","1.0","0.6666666666666666","1","6","3","false","9224","2.3333333333333335","3","3","false","0","9224","5"
"1.3333333333333333","0.0","0.75","1.0","2","4","2","false","10154","3.0","2","2","false","0","10154","0"
"1.3333333333333333","0.0","0.75","1.0","2","4","2","false","11410","3.0","2","2","false","0","11410","0"
"1.0","0.41666666666666663","1.0","0.6666666666666666","1","6","3","false","16830","2.3333333333333335","3","3","false","0","16830","5"
"1.0","0.0","1.0","1.0","1","4","2","false","4144","2.0","2","2","false","0","4144","0"
"1.0","0.0","1.0","1.0","1","4","2","false","18596","2.0","2","2","false","0","18596","0"
"1.0","0.0","1.0","1.0","1","4","2","false","23771","2.0","2","2","false","0","23771","0"
"1.0","0.0","1.0","0.0","1","2","1","false","16622","1.0","1","1","false","0","16622","0"
"1.0","0.0","1.0","0.0","1","2","1","false","18454","1.0","1","1","false","0","18454","0"
"1.0","1.1666666666666665","1.0","0.3333333333333333","1","6","3","false","13031","1.6666666666666667","3","3","false","0","13031","7"
"1.3333333333333333","0.0","0.75","1.0","2","4","2","false","8738","2.5","2","2","false","0","8738","0"
"1.3333333333333333","0.0","0.75","1.0","2","4","2","false","13334","2.5","2","2","false","0","13334","0"
"1.6666666666666667","0.0","0.6","0.0","2","2","1","false","13620","3.0","1","1","false","0","13620","0"
"1.0","0.0","1.0","0.0","1","2","1","false","16312","1.0","1","1","false","0","16312","0"
"1.0","0.0","1.0","0.0","1","2","1","false","16314","1.0","1","1","false","0","16314","0"
"6.542458503728651","0.0","0.15284774055962055","0.0","13","2","1","false","20515","4.0","1","1","false","0","20515","0"
"6.309357709886938","0.06954969956665748","0.15849473844746073","0.9722222222222222","12","18","9","false","23915","9.555555555555555","9","9","false","0","23915","34821423"
"6.309357709886938","0.06954969956665748","0.15849473844746073","0.9722222222222222","12","18","9","false","12266","9.555555555555555","9","9","false","0","12266","34821423"
"6.309357709886938","0.06954969956665748","0.15849473844746073","0.9722222222222222","12","18","9","false","15678","9.555555555555555","9","9","false","0","15678","34821423"
"6.309357709886938","0.06954969956665748","0.15849473844746073","0.9722222222222222","12","18","9","false","17134","9.555555555555555","9","9","false","0","17134","34821423"
"6.309357709886938","0.06954969956665748","0.15849473844746073","0.9722222222222222","12","18","9","false","21436","9.555555555555555","9","9","false","0","21436","34821423"
"7.0930959826798174","0.0","0.14098216102557146","1.0","13","16","8","false","23146","9.125","8","8","false","0","23146","0"
"6.309357709886938","0.06954969956665748","0.15849473844746073","0.9722222222222222","12","18","9","false","23488","9.555555555555555","9","9","false","0","23488","34821423"
"6.309357709886938","0.06954969956665748","0.15849473844746073","0.9722222222222222","12","18","9","false","25575","9.555555555555555","9","9","false","0","25575","34821423"
"1.0","0.0","1.0","0.0","1","2","1","false","11991","1.0","1","1","false","0","11991","0"
"1.0","0.0","1.0","0.0","1","2","1","false","3186","1.0","1","1","false","0","3186","0"
"1.0","0.0","1.0","0.0","1","2","1","false","14182","1.0","1","1","false","0","14182","0"
"1.0","0.0","1.0","0.0","1","2","1","false","17537","1.0","1","1","false","0","17537","0"
"1.0","0.0","1.0","1.0","1","4","2","false","15358","2.0","2","2","false","0","15358","0"
"1.0","0.0","1.0","1.0","1","4","2","false","18036","2.0","2","2","false","0","18036","0"
"1.0","0.0","1.0","1.0","1","4","2","false","18338","2.0","2","2","false","0","18338","0"
"7.519605484724561","0.0","0.1329857001183659","1.0","13","4","2","false","9631","2.5","2","2","false","0","9631","0"
"7.519605484724561","0.0","0.1329857001183659","1.0","13","4","2","false","10898","2.5","2","2","false","0","10898","0"
"1.0","0.0","1.0","1.0","1","4","2","false","14175","2.0","2","2","false","0","14175","0"
"1.0","0.0","1.0","1.0","1","4","2","false","12307","2.0","2","2","false","0","12307","0"
"1.0","0.0","1.0","1.0","1","4","2","false","22980","2.0","2","2","false","0","22980","0"
"1.0","0.0","1.0","0.0","1","2","1","false","5387","1.0","1","1","false","0","5387","0"
"1.0","0.0","1.0","0.0","1","2","1","false","18156","1.0","1","1","false","0","18156","0"
"1.0","0.0","1.0","0.0","1","2","1","false","19145","1.0","1","1","false","0","19145","0"
"1.0","0.0","1.0","0.0","1","2","1","false","23760","1.0","1","1","false","0","23760","0"
"1.0","0.0","1.0","1.0","1","4","2","false","1983","2.0","2","2","false","0","1983","0"
"1.0","0.0","1.0","1.0","1","4","2","false","13012","2.0","2","2","false","0","13012","0"
"1.0","0.0","1.0","1.0","1","4","2","false","20943","2.0","2","2","false","0","20943","0"
"1.0","0.0","1.0","0.0","1","2","1","false","22110","1.0","1","1","false","0","22110","0"
"1.0","0.0","1.0","0.0","1","2","1","false","5231","1.0","1","1","false","0","5231","0"
"1.0","0.0","1.0","0.0","1","2","1","false","22311","1.0","1","1","false","0","22311","0"
"1.0","0.0","1.0","0.0","1","2","1","false","20084","1.0","1","1","false","0","20084","0"
"1.0","0.0","1.0","1.0","1","4","2","false","6576","2.0","2","2","false","0","6576","0"
"1.0","0.0","1.0","1.0","1","4","2","false","1621","2.0","2","2","false","0","1621","0"
"1.0","0.0","1.0","1.0","1","4","2","false","7109","2.0","2","2","false","0","7109","0"
"7.4354101515516","0.0","0.1344915720340354","1.0","13","6","3","false","9018","11.0","3","3","false","0","9018","0"
"7.43516959345682","0.0","0.13449592338553126","1.0","13","8","4","false","14374","9.25","4","4","false","0","14374","0"
"7.43492903536204","6.820443255108364E-5","0.1345002750186042","0.8","13","10","5","false","18299","7.8","5","5","false","0","18299","3535"
"7.43516959345682","0.0","0.13449592338553126","1.0","13","8","4","false","19687","9.25","4","4","false","0","19687","0"
"1.0","0.0","1.0","0.0","1","2","1","false","12751","1.0","1","1","false","0","12751","0"
"1.0","0.0","1.0","0.0","1","2","1","false","6307","1.0","1","1","false","0","6307","0"
"1.0","0.0","1.0","1.0","1","4","2","false","13486","2.0","2","2","false","0","13486","0"
"1.0","0.0","1.0","1.0","1","4","2","false","4259","2.0","2","2","false","0","4259","0"
"1.0","0.0","1.0","1.0","1","4","2","false","18688","2.0","2","2","false","0","18688","0"
"1.0","0.0","1.0","1.0","1","6","3","false","4630","3.0","3","3","false","0","4630","0"
"1.0","0.0","1.0","1.0","1","6","3","false","9921","3.0","3","3","false","0","9921","0"
"1.0","0.0","1.0","1.0","1","6","3","false","10672","3.0","3","3","false","0","10672","0"
"1.0","0.0","1.0","1.0","1","6","3","false","12512","3.0","3","3","false","0","12512","0"
"1.0","0.0","1.0","0.0","1","2","1","false","831","1.0","1","1","false","0","831","0"
"1.0","0.0","1.0","0.0","1","2","1","false","11280","1.0","1","1","false","0","11280","0"
"1.0","0.0","1.0","0.0","1","2","1","false","15154","1.0","1","1","false","0","15154","0"
"1.0","0.0","1.0","0.0","1","2","1","false","14132","1.0","1","1","false","0","14132","0"
"1.6","0.0","0.625","1.0","2","4","2","false","4034","3.5","2","2","false","0","4034","0"
"1.0","2.0500000000000003","1.0","0.4","1","10","5","false","9715","2.6","5","5","false","0","9715","41"
"1.6","0.0","0.625","1.0","2","4","2","false","9717","3.5","2","2","false","0","9717","0"
"1.4","0.0","0.7142857142857143","1.0","2","6","3","false","8512","3.6666666666666665","3","3","false","0","8512","0"
"1.4","0.0","0.7142857142857143","1.0","2","6","3","false","25492","3.6666666666666665","3","3","false","0","25492","0"
"1.4","0.0","0.7142857142857143","1.0","2","6","3","false","25511","3.6666666666666665","3","3","false","0","25511","0"
"1.0","0.0","1.0","1.0","1","4","2","false","1798","2.0","2","2","false","0","1798","0"
"1.0","0.0","1.0","1.0","1","4","2","false","4828","2.0","2","2","false","0","4828","0"
"1.0","0.0","1.0","1.0","1","4","2","false","5404","2.0","2","2","false","0","5404","0"
"1.0","0.0","1.0","0.0","1","2","1","false","24462","1.0","1","1","false","0","24462","0"
"1.0","0.0","1.0","0.0","1","2","1","false","11641","1.0","1","1","false","0","11641","0"
"1.0","0.0","1.0","0.0","1","2","1","false","14338","1.0","1","1","false","0","14338","0"
"1.0","0.0","1.0","0.0","1","2","1","false","22729","1.0","1","1","false","0","22729","0"
"6.915564108732259","0.0","0.14460136357311815","1.0","13","4","2","false","677","3.0","2","2","false","0","677","0"
"6.915564108732259","0.0","0.14460136357311815","1.0","13","4","2","false","4426","3.0","2","2","false","0","4426","0"
"6.377435650709646","0.0","0.1568028365584097","1.0","12","4","2","false","4242","4.5","2","2","false","0","4242","0"
"1.0","0.0","1.0","1.0","1","4","2","false","19466","2.0","2","2","false","0","19466","0"
"1.0","0.0","1.0","1.0","1","4","2","false","7543","2.0","2","2","false","0","7543","0"
"1.0","0.0","1.0","1.0","1","4","2","false","24128","2.0","2","2","false","0","24128","0"
"7.829925426990618","0.0","0.12771513717779348","0.0","13","2","1","false","17581","2.0","1","1","false","0","17581","0"
"6.807072407986529","0.0","0.14690603244160158","0.0","12","2","1","false","10446","4.0","1","1","false","0","10446","0"
"1.0","0.0","1.0","0.0","1","2","1","false","11411","1.0","1","1","false","0","11411","0"
"1.0","0.0","1.0","0.0","1","2","1","false","24242","1.0","1","1","false","0","24242","0"
"1.0","0.0","1.0","0.0","1","2","1","false","5853","1.0","1","1","false","0","5853","0"
"1.0","0.0","1.0","0.0","1","2","1","false","5492","1.0","1","1","false","0","5492","0"
"7.144094298773154","0.0","0.13997575594316117","0.0","13","2","1","false","9979","3.0","1","1","false","0","9979","0"
"7.431320663940341","0.6514790155316252","0.13456558332254306","0.0","13","4","2","false","18094","2.0","2","2","false","0","18094","52695290"
"8.431080105845561","0.0","0.11860876512211824","0.0","14","2","1","false","8870","2.0","1","1","false","0","8870","0"
"1.0","0.0","1.0","0.0","1","2","1","false","9831","1.0","1","1","false","0","9831","0"
"1.0","0.0","1.0","0.0","1","2","1","false","12473","1.0","1","1","false","0","12473","0"
"1.0","0.0","1.0","0.0","1","2","1","false","18388","1.0","1","1","false","0","18388","0"
"1.0","0.0","1.0","0.0","1","2","1","false","20654","1.0","1","1","false","0","20654","0"
"7.595862400769786","0.0","0.13165062072460096","0.0","14","2","1","false","9867","3.0","1","1","false","0","9867","0"
"7.595381284580226","0.0","0.13165895990371826","1.0","14","4","2","false","4037","3.0","2","2","false","0","4037","0"
"7.595381284580226","0.0","0.13165895990371826","1.0","14","4","2","false","25663","3.0","2","2","false","0","25663","0"
"1.0","0.0","1.0","0.0","1","2","1","false","4196","1.0","1","1","false","0","4196","0"
"1.0","0.0","1.0","0.0","1","2","1","false","15401","1.0","1","1","false","0","15401","0"
"1.0","0.0","1.0","1.0","1","4","2","false","1051","2.0","2","2","false","0","1051","0"
"1.0","0.0","1.0","1.0","1","4","2","false","4245","2.0","2","2","false","0","4245","0"
"1.0","0.0","1.0","1.0","1","4","2","false","25664","2.0","2","2","false","0","25664","0"
"6.3853740678373825","0.0","0.1566078963230862","0.0","12","2","1","false","24140","5.0","1","1","false","0","24140","0"
"1.0","0.0","1.0","1.0","1","6","3","false","16823","3.0","3","3","false","0","16823","0"
"1.0","0.0","1.0","1.0","1","6","3","false","5571","3.0","3","3","false","0","5571","0"
"1.0","0.0","1.0","1.0","1","6","3","false","13802","3.0","3","3","false","0","13802","0"
"1.0","0.0","1.0","1.0","1","6","3","false","19553","3.0","3","3","false","0","19553","0"
"1.0","0.0","1.0","0.0","1","2","1","false","25447","1.0","1","1","false","0","25447","0"
"1.0","0.0","1.0","0.0","1","2","1","false","15962","1.0","1","1","false","0","15962","0"
"1.0","0.0","1.0","0.0","1","2","1","false","19892","1.0","1","1","false","0","19892","0"
"1.0","0.0","1.0","0.0","1","2","1","false","18417","1.0","1","1","false","0","18417","0"
"1.0","0.0","1.0","0.0","1","2","1","false","4643","1.0","1","1","false","0","4643","0"
"1.0","0.0","1.0","0.0","1","2","1","false","20320","1.0","1","1","false","0","20320","0"
"1.0","0.0","1.0","0.0","1","2","1","false","14990","1.0","1","1","false","0","14990","0"
"1.0","0.0","1.0","0.0","1","2","1","false","25975","1.0","1","1","false","0","25975","0"
"7.820784219388982","0.0","0.12786441512103597","1.0","13","6","3","false","24708","14.333333333333334","3","3","false","0","24708","0"
"7.820784219388982","0.0","0.12786441512103597","1.0","13","6","3","false","19443","14.333333333333334","3","3","false","0","19443","0"
"7.820784219388982","0.0","0.12786441512103597","1.0","13","6","3","false","23492","14.333333333333334","3","3","false","0","23492","0"
"1.0","0.0","1.0","1.0","1","4","2","false","8395","2.0","2","2","false","0","8395","0"
"1.0","0.0","1.0","1.0","1","4","2","false","8725","2.0","2","2","false","0","8725","0"
"1.0","0.0","1.0","1.0","1","4","2","false","11054","2.0","2","2","false","0","11054","0"
"1.0","0.0","1.0","0.0","1","2","1","false","14763","1.0","1","1","false","0","14763","0"
"1.0","0.0","1.0","0.0","1","2","1","false","4432","1.0","1","1","false","0","4432","0"
"6.628097185470291","0.0","0.15087286320908794","0.0","11","2","1","false","5062","3.0","1","1","false","0","5062","0"
"6.628097185470291","0.0","0.15087286320908794","0.0","11","2","1","false","19881","3.0","1","1","false","0","19881","0"
"1.0","0.0","1.0","0.0","1","2","1","false","20766","1.0","1","1","false","0","20766","0"
"1.0","0.0","1.0","0.0","1","2","1","false","11718","1.0","1","1","false","0","11718","0"
"1.0","0.0","1.0","0.0","1","2","1","false","15553","1.0","1","1","false","0","15553","0"
"1.0","0.0","1.0","0.0","1","2","1","false","15374","1.0","1","1","false","0","15374","0"
"1.0","0.0","1.0","0.0","1","2","1","false","5490","1.0","1","1","false","0","5490","0"
"1.0","0.0","1.0","0.0","1","2","1","false","8474","1.0","1","1","false","0","8474","0"
"1.0","0.0","1.0","0.0","1","2","1","false","1976","1.0","1","1","false","0","1976","0"
"1.0","0.0","1.0","0.0","1","2","1","false","23672","1.0","1","1","false","0","23672","0"
"0.0","0.0","0.0","0.0","0","2","1","true","12295","NaN","1","0","false","1","12295","0"
"1.0","0.0","1.0","1.0","1","10","5","false","9189","5.0","5","5","false","0","9189","0"
"1.0","0.0","1.0","1.0","1","10","5","false","2116","5.0","5","5","false","0","2116","0"
"1.0","0.0","1.0","1.0","1","10","5","false","9765","5.0","5","5","false","0","9765","0"
"1.0","0.0","1.0","1.0","1","10","5","false","9774","5.0","5","5","false","0","9774","0"
"1.0","0.0","1.0","1.0","1","10","5","false","12034","5.0","5","5","false","0","12034","0"
"1.0","0.0","1.0","1.0","1","10","5","false","17935","5.0","5","5","false","0","17935","0"
"1.0","0.0","1.0","0.0","1","2","1","false","12248","1.0","1","1","false","0","12248","0"
"1.0","0.0","1.0","0.0","1","2","1","false","98","1.0","1","1","false","0","98","0"
"6.542217945633871","0.0","0.1528533607883512","0.0","12","2","1","false","10116","3.0","1","1","false","0","10116","0"
"1.0","0.0","1.0","0.0","1","2","1","false","4181","1.0","1","1","false","0","4181","0"
"1.0","0.0","1.0","0.0","1","2","1","false","17992","1.0","1","1","false","0","17992","0"
"1.0","0.0","1.0","0.0","1","2","1","false","8409","1.0","1","1","false","0","8409","0"
"1.0","0.0","1.0","0.0","1","2","1","false","2248","1.0","1","1","false","0","2248","0"
"1.0","0.0","1.0","0.0","1","2","1","false","11579","1.0","1","1","false","0","11579","0"
"1.0","0.0","1.0","0.0","1","2","1","false","15073","1.0","1","1","false","0","15073","0"
"1.0","0.0","1.0","0.0","1","2","1","false","16922","1.0","1","1","false","0","16922","0"
"1.0","0.0","1.0","0.0","1","2","1","false","20925","1.0","1","1","false","0","20925","0"
"8.559057012268463","0.0","0.1168353007307476","0.0","14","2","1","false","22645","2.0","1","1","false","0","22645","0"
"1.0","0.0","1.0","1.0","1","4","2","false","13415","2.0","2","2","false","0","13415","0"
"1.0","0.0","1.0","1.0","1","4","2","false","7585","2.0","2","2","false","0","7585","0"
"1.0","0.0","1.0","1.0","1","4","2","false","15386","2.0","2","2","false","0","15386","0"
"1.0","0.0","1.0","0.0","1","2","1","false","23772","1.0","1","1","false","0","23772","0"
"1.0","0.0","1.0","0.0","1","2","1","false","735","1.0","1","1","false","0","735","0"
"6.845802261246091","0.0","0.146074917422166","0.0","11","2","1","false","6078","3.0","1","1","false","0","6078","0"
"1.0","0.0","1.0","1.0","1","4","2","false","74","2.0","2","2","false","0","74","0"
"1.0","0.0","1.0","1.0","1","4","2","false","2298","2.0","2","2","false","0","2298","0"
"1.0","0.0","1.0","1.0","1","4","2","false","16129","2.0","2","2","false","0","16129","0"
"1.0","0.0","1.0","0.0","1","2","1","false","8717","1.0","1","1","false","0","8717","0"
"1.0","0.0","1.0","0.0","1","2","1","false","10638","1.0","1","1","false","0","10638","0"
"1.0","0.0","1.0","1.0","1","12","6","false","13558","6.0","6","6","false","0","13558","0"
"1.0","0.0","1.0","1.0","1","12","6","false","8669","6.0","6","6","false","0","8669","0"
"1.0","0.0","1.0","1.0","1","12","6","false","9038","6.0","6","6","false","0","9038","0"
"1.0","0.0","1.0","1.0","1","12","6","false","12213","6.0","6","6","false","0","12213","0"
"1.0","0.0","1.0","1.0","1","12","6","false","21710","6.0","6","6","false","0","21710","0"
"1.0","0.0","1.0","1.0","1","12","6","false","22318","6.0","6","6","false","0","22318","0"
"1.0","0.0","1.0","1.0","1","12","6","false","24888","6.0","6","6","false","0","24888","0"
"6.9600673562665385","0.0","0.14367677046970587","0.0","13","2","1","false","22728","4.0","1","1","false","0","22728","0"
"1.0","0.0","1.0","0.0","1","2","1","false","2561","1.0","1","1","false","0","2561","0"
"1.0","0.0","1.0","0.0","1","2","1","false","23094","1.0","1","1","false","0","23094","0"
"1.0","0.0","1.0","1.0","1","4","2","false","1969","2.0","2","2","false","0","1969","0"
"1.0","0.0","1.0","1.0","1","4","2","false","8472","2.0","2","2","false","0","8472","0"
"1.0","0.0","1.0","1.0","1","4","2","false","24141","2.0","2","2","false","0","24141","0"
"1.0","0.0","1.0","1.0","1","4","2","false","16971","2.0","2","2","false","0","16971","0"
"1.0","0.0","1.0","1.0","1","4","2","false","5228","2.0","2","2","false","0","5228","0"
"1.0","0.0","1.0","1.0","1","4","2","false","20170","2.0","2","2","false","0","20170","0"
"1.0","1.5","1.0","0.0","1","4","2","false","18608","1.0","2","2","false","0","18608","3"
"1.5","0.0","0.6666666666666666","0.0","2","2","1","false","14339","2.0","1","1","false","0","14339","0"
"1.5","0.0","0.6666666666666666","0.0","2","2","1","false","22816","2.0","1","1","false","0","22816","0"
"1.0","0.0","1.0","1.0","1","4","2","false","7280","2.0","2","2","false","0","7280","0"
"1.0","0.0","1.0","1.0","1","4","2","false","7267","2.0","2","2","false","0","7267","0"
"1.0","0.0","1.0","1.0","1","4","2","false","20309","2.0","2","2","false","0","20309","0"
"1.0","0.0","1.0","1.0","1","4","2","false","8891","2.0","2","2","false","0","8891","0"
"1.0","0.0","1.0","1.0","1","4","2","false","11893","2.0","2","2","false","0","11893","0"
"1.0","0.0","1.0","1.0","1","4","2","false","25667","2.0","2","2","false","0","25667","0"
"1.0","0.0","1.0","0.0","1","2","1","false","6776","1.0","1","1","false","0","6776","0"
"1.0","0.0","1.0","0.0","1","2","1","false","24733","1.0","1","1","false","0","24733","0"
"7.288910271830647","0.0","0.1371947194719472","0.0","13","2","1","false","18455","2.0","1","1","false","0","18455","0"
"1.0","0.0","1.0","1.0","1","4","2","false","2334","2.0","2","2","false","0","2334","0"
"1.0","0.0","1.0","1.0","1","4","2","false","10180","2.0","2","2","false","0","10180","0"
"1.0","0.0","1.0","1.0","1","4","2","false","17587","2.0","2","2","false","0","17587","0"
"1.0","0.0","1.0","0.0","1","2","1","false","11215","1.0","1","1","false","0","11215","0"
"1.0","0.0","1.0","0.0","1","2","1","false","23156","1.0","1","1","false","0","23156","0"
"1.0","0.0","1.0","1.0","1","4","2","false","23970","2.0","2","2","false","0","23970","0"
"1.0","0.0","1.0","1.0","1","4","2","false","7718","2.0","2","2","false","0","7718","0"
"1.0","0.0","1.0","1.0","1","4","2","false","19502","2.0","2","2","false","0","19502","0"
"1.0","0.0","1.0","0.0","1","2","1","false","3748","1.0","1","1","false","0","3748","0"
"1.0","0.0","1.0","0.0","1","2","1","false","17503","1.0","1","1","false","0","17503","0"
"1.0","0.0","1.0","0.0","1","2","1","false","10602","1.0","1","1","false","0","10602","0"
"1.0","0.0","1.0","0.0","1","2","1","false","20805","1.0","1","1","false","0","20805","0"
"1.0","0.0","1.0","0.0","1","2","1","false","11467","1.0","1","1","false","0","11467","0"
"1.0","0.0","1.0","0.0","1","2","1","false","19575","1.0","1","1","false","0","19575","0"
"1.0","0.0","1.0","1.0","1","4","2","false","4038","2.0","2","2","false","0","4038","0"
"1.0","0.0","1.0","1.0","1","4","2","false","7058","2.0","2","2","false","0","7058","0"
"1.0","0.0","1.0","1.0","1","4","2","false","23811","2.0","2","2","false","0","23811","0"
"1.0","0.0","1.0","1.0","1","4","2","false","1878","2.0","2","2","false","0","1878","0"
"1.0","0.0","1.0","1.0","1","4","2","false","12338","2.0","2","2","false","0","12338","0"
"1.0","0.0","1.0","1.0","1","4","2","false","15800","2.0","2","2","false","0","15800","0"
"1.0","0.0","1.0","0.0","1","2","1","false","9130","1.0","1","1","false","0","9130","0"
"1.0","0.0","1.0","0.0","1","2","1","false","25095","1.0","1","1","false","0","25095","0"
"6.4204955496752465","0.0","0.15575121768452604","0.0","12","2","1","false","20066","3.0","1","1","false","0","20066","0"
"1.0","0.0","1.0","0.0","1","2","1","false","1010","1.0","1","1","false","0","1010","0"
"1.0","0.0","1.0","0.0","1","2","1","false","2749","1.0","1","1","false","0","2749","0"
"7.266778927110897","0.0","0.1376125529661017","0.0","12","2","1","false","5829","2.0","1","1","false","0","5829","0"
"1.0","0.0","1.0","0.0","1","2","1","false","11642","1.0","1","1","false","0","11642","0"
"1.0","0.0","1.0","0.0","1","2","1","false","25230","1.0","1","1","false","0","25230","0"
"1.0","0.0","1.0","1.0","1","4","2","false","5256","2.0","2","2","false","0","5256","0"
"1.0","0.0","1.0","1.0","1","4","2","false","5257","2.0","2","2","false","0","5257","0"
"1.0","0.0","1.0","1.0","1","4","2","false","22827","2.0","2","2","false","0","22827","0"
"1.0","0.0","1.0","0.0","1","2","1","false","16015","1.0","1","1","false","0","16015","0"
"1.0","0.0","1.0","0.0","1","2","1","false","22938","1.0","1","1","false","0","22938","0"
"7.734904979552562","0.0","0.12928407041114637","0.0","13","2","1","false","15774","4.0","1","1","false","0","15774","0"
"1.0","0.0","1.0","0.0","1","2","1","false","20333","1.0","1","1","false","0","20333","0"
"1.0","0.0","1.0","0.0","1","2","1","false","4262","1.0","1","1","false","0","4262","0"
"1.0","0.0","1.0","0.0","1","2","1","false","6701","1.0","1","1","false","0","6701","0"
"1.0","0.0","1.0","0.0","1","2","1","false","10407","1.0","1","1","false","0","10407","0"
"1.0","0.0","1.0","0.0","1","2","1","false","5406","1.0","1","1","false","0","5406","0"
"1.0","0.0","1.0","0.0","1","2","1","false","22435","1.0","1","1","false","0","22435","0"
"1.0","2.0","1.0","0.0","1","6","3","false","11120","1.0","3","3","false","0","11120","12"
"1.6666666666666667","0.0","0.6","0.0","2","2","1","false","16340","3.0","1","1","false","0","16340","0"
"1.6666666666666667","0.0","0.6","0.0","2","2","1","false","17851","3.0","1","1","false","0","17851","0"
"1.6666666666666667","0.0","0.6","0.0","2","2","1","false","20233","3.0","1","1","false","0","20233","0"
"1.0","0.0","1.0","0.0","1","2","1","false","4366","1.0","1","1","false","0","4366","0"
"1.0","0.0","1.0","0.0","1","2","1","false","410","1.0","1","1","false","0","410","0"
"1.0","0.0","1.0","0.0","1","2","1","false","9211","1.0","1","1","false","0","9211","0"
"1.0","0.0","1.0","0.0","1","2","1","false","13413","1.0","1","1","false","0","13413","0"
"1.0","0.0","1.0","0.0","1","2","1","false","19473","1.0","1","1","false","0","19473","0"
"1.0","0.0","1.0","0.0","1","2","1","false","23812","1.0","1","1","false","0","23812","0"
"1.0","0.0","1.0","0.0","1","2","1","false","24214","1.0","1","1","false","0","24214","0"
"1.0","0.0","1.0","0.0","1","2","1","false","4116","1.0","1","1","false","0","4116","0"
"1.0","0.0","1.0","1.0","1","10","5","false","25496","5.0","5","5","false","0","25496","0"
"1.0","0.0","1.0","1.0","1","10","5","false","19314","5.0","5","5","false","0","19314","0"
"1.0","0.0","1.0","1.0","1","10","5","false","19880","5.0","5","5","false","0","19880","0"
"1.0","0.0","1.0","1.0","1","10","5","false","25543","5.0","5","5","false","0","25543","0"
"1.0","0.0","1.0","1.0","1","10","5","false","26019","5.0","5","5","false","0","26019","0"
"1.0","0.0","1.0","1.0","1","10","5","false","26048","5.0","5","5","false","0","26048","0"
"1.0","0.0","1.0","0.0","1","2","1","false","24820","1.0","1","1","false","0","24820","0"
"1.0","0.0","1.0","0.0","1","2","1","false","20707","1.0","1","1","false","0","20707","0"
"1.0","0.0","1.0","0.0","1","2","1","false","5486","1.0","1","1","false","0","5486","0"
"1.0","0.0","1.0","0.0","1","2","1","false","8366","1.0","1","1","false","0","8366","0"
"1.0","0.0","1.0","0.0","1","2","1","false","5261","1.0","1","1","false","0","5261","0"
"1.0","0.0","1.0","0.0","1","2","1","false","6282","1.0","1","1","false","0","6282","0"
"1.0","0.0","1.0","0.0","1","2","1","false","18908","1.0","1","1","false","0","18908","0"
"1.0","0.0","1.0","0.0","1","2","1","false","25531","1.0","1","1","false","0","25531","0"
"1.0","0.0","1.0","0.0","1","2","1","false","12050","1.0","1","1","false","0","12050","0"
"1.0","0.0","1.0","0.0","1","2","1","false","5364","1.0","1","1","false","0","5364","0"
"1.0","0.0","1.0","0.0","1","2","1","false","14","1.0","1","1","false","0","14","0"
"1.0","0.0","1.0","0.0","1","2","1","false","14171","1.0","1","1","false","0","14171","0"
"1.0","0.0","1.0","1.0","1","4","2","false","14845","2.0","2","2","false","0","14845","0"
"1.0","0.0","1.0","1.0","1","4","2","false","5232","2.0","2","2","false","0","5232","0"
"1.0","0.0","1.0","1.0","1","4","2","false","19521","2.0","2","2","false","0","19521","0"
